gameid,home,team,SEC,PTS,contestedshots,contestedshots2P,contestedshots3P,deflections,chargesdrawn,screenAST,screenASTPTS,looseballsrecoveredOFF,looseballsrecoveredDEF,looseballsrecoveredtotal,OFFboxouts,DEFboxouts,boxoutplayerteamREB,boxoutplayerREB,boxouts
22200001,True,BOS,14400,126,34,19,15,16,2,10,22,2,2,4,0,2,2,0,2
22200001,False,PHI,14400,117,27,15,12,16,0,9,19,0,1,1,0,6,6,4,6
22200002,True,GSW,14400,123,62,29,33,23,1,18,43,1,2,3,3,11,12,6,14
22200002,False,LAL,14400,109,71,35,36,18,1,3,8,5,2,7,2,11,13,7,13
22200003,True,DET,14400,113,59,40,19,15,0,8,19,4,4,8,1,11,10,4,12
22200003,False,ORL,14400,109,60,34,26,11,0,10,26,5,1,6,2,12,11,6,14
22200004,True,IND,14400,107,62,41,21,12,1,8,17,3,2,5,3,5,7,3,8
22200004,False,WAS,14400,114,67,36,31,14,0,9,20,3,2,5,2,11,13,10,13
22200005,True,ATL,14400,117,67,39,28,16,1,13,27,1,5,6,1,8,4,1,9
22200005,False,HOU,14400,107,54,37,17,11,0,11,26,6,2,8,0,11,8,1,11
22200006,True,BKN,14400,108,57,44,13,21,0,14,34,3,4,7,3,9,11,7,12
22200006,False,NOP,14400,130,49,31,18,18,0,10,24,3,1,4,3,11,14,6,14
22200007,True,MIA,14400,108,44,25,19,14,1,8,19,2,3,5,1,6,6,2,7
22200007,False,CHI,14400,116,46,24,22,15,0,13,31,2,2,4,2,3,5,4,5
22200008,True,TOR,14400,108,44,30,14,16,0,4,9,3,5,8,0,4,2,0,4
22200008,False,CLE,14400,105,52,33,19,8,0,7,15,3,2,5,0,7,3,1,7
22200009,True,MEM,15900,115,55,30,25,13,3,8,18,4,0,4,4,6,10,5,10
22200009,False,NYK,15900,112,64,32,32,22,1,6,13,3,3,6,1,6,7,2,7
22200010,True,MIN,14400,115,61,33,28,19,2,6,14,1,4,5,1,5,3,1,6
22200010,False,OKC,14400,108,56,29,27,24,2,6,15,4,4,8,1,10,9,2,11
22200011,True,SAS,14400,102,52,34,18,15,0,2,4,2,3,5,1,2,3,2,3
22200011,False,CHA,14400,129,53,27,26,13,0,7,14,3,2,5,2,4,5,4,6
22200012,True,UTA,14400,123,46,34,12,18,1,8,20,3,3,6,2,4,6,3,6
22200012,False,DEN,14400,102,57,29,28,19,1,6,13,4,6,10,0,6,4,0,6
22200013,True,PHX,14400,107,49,28,21,11,0,2,4,1,2,3,1,5,4,1,6
22200013,False,DAL,14400,105,52,40,12,7,0,5,11,1,5,6,1,2,3,2,3
22200014,True,SAC,14400,108,57,36,21,22,0,8,20,1,4,5,0,7,6,3,7
22200014,False,POR,14400,115,57,25,32,14,1,8,20,3,4,7,0,3,3,2,3
22200015,True,PHI,14400,88,41,23,18,10,1,8,16,1,3,4,0,11,8,1,11
22200015,False,MIL,14400,90,60,42,18,12,0,7,15,1,3,4,2,4,5,0,6
22200016,True,LAL,14400,97,47,29,18,22,1,2,5,1,1,2,0,4,2,2,4
22200016,False,LAC,14400,103,55,28,27,16,1,10,22,1,1,2,2,1,3,2,3
22200017,True,CHA,14400,112,56,41,15,27,0,6,14,3,4,7,1,4,4,1,5
22200017,False,NOP,14400,124,60,41,19,17,0,10,21,2,3,5,2,11,13,9,13
22200018,True,IND,14400,134,56,36,20,15,2,13,30,6,3,9,0,9,5,2,9
22200018,False,SAS,14400,137,58,40,18,15,0,8,18,0,5,5,2,8,8,6,10
22200019,True,WAS,14400,102,47,35,12,13,1,10,20,3,0,3,0,4,4,1,4
22200019,False,CHI,14400,100,50,33,17,16,0,11,23,3,5,8,0,7,7,4,7
22200020,True,ATL,14400,108,48,25,23,17,2,4,10,1,4,5,1,3,3,1,4
22200020,False,ORL,14400,98,53,28,25,11,0,14,29,0,2,2,0,3,3,1,3
22200021,True,BKN,14400,109,48,29,19,9,1,10,23,2,0,2,0,6,5,2,6
22200021,False,TOR,14400,105,51,27,24,16,0,5,13,3,2,5,0,1,1,1,1
22200022,True,MIA,14400,104,49,29,20,10,0,16,34,4,1,5,0,4,4,1,4
22200022,False,BOS,14400,111,53,38,15,6,0,7,17,4,2,6,1,1,2,1,2
22200023,True,NYK,14400,130,54,28,26,15,1,9,19,5,9,14,1,14,11,5,15
22200023,False,DET,14400,106,54,27,27,15,0,9,21,3,3,6,3,9,10,6,12
22200024,True,HOU,14400,122,60,36,24,15,0,8,20,2,2,4,1,7,4,3,8
22200024,False,MEM,14400,129,65,35,30,24,1,11,27,5,2,7,0,7,5,0,7
22200025,True,MIN,15900,126,69,32,37,9,0,12,28,0,3,3,5,5,10,9,10
22200025,False,UTA,15900,132,68,46,22,16,0,10,27,4,5,9,1,4,5,5,5
22200026,True,GSW,14400,123,48,24,24,23,0,5,14,1,2,3,1,5,6,3,6
22200026,False,DEN,14400,128,34,16,18,22,1,6,13,0,0,0,1,3,4,4,4
22200027,True,POR,15900,113,51,38,13,11,0,9,20,2,3,5,0,2,1,0,2
22200027,False,PHX,15900,111,42,28,14,25,3,6,12,3,4,7,1,8,7,2,9
22200028,True,PHI,14400,105,46,28,18,10,1,6,13,0,1,1,0,2,2,1,2
22200028,False,SAS,14400,114,46,30,16,9,1,13,29,2,1,3,2,4,6,4,6
22200029,True,IND,14400,124,61,42,19,19,0,13,28,5,4,9,1,12,7,2,13
22200029,False,DET,14400,115,56,35,21,12,0,7,17,4,4,8,3,8,11,6,11
22200030,True,ORL,14400,120,40,15,25,11,1,14,32,4,3,7,2,1,1,1,3
22200030,False,BOS,14400,126,55,36,19,17,1,15,36,0,1,1,1,8,9,1,9
22200031,True,MIA,14400,112,57,28,29,5,1,9,20,2,2,4,0,7,5,1,7
22200031,False,TOR,14400,109,51,32,19,19,0,2,5,4,5,9,1,2,2,1,3
22200032,True,CHI,14400,96,57,36,21,22,0,8,18,1,2,3,2,5,7,5,7
22200032,False,CLE,14400,128,53,36,17,15,2,10,26,4,1,5,1,3,4,2,4
22200033,True,MIL,14400,125,55,31,24,8,1,4,10,1,1,2,0,9,9,6,9
22200033,False,HOU,14400,105,49,31,18,16,0,8,19,4,2,6,4,4,8,5,8
22200034,True,DAL,14400,137,52,33,19,22,0,8,21,0,3,3,1,8,9,6,9
22200034,False,MEM,14400,96,61,31,30,15,1,6,12,0,0,0,1,6,7,4,7
22200035,True,DEN,14400,122,55,28,27,13,0,7,17,1,2,3,3,1,4,4,4
22200035,False,OKC,14400,117,54,30,24,16,1,2,4,3,1,4,1,7,6,4,8
22200036,True,SAC,14400,109,57,41,16,15,0,8,18,1,2,3,2,3,5,3,5
22200036,False,LAC,14400,111,52,34,18,15,0,8,19,2,8,10,0,7,7,2,7
22200037,True,LAL,14400,104,47,28,19,20,2,4,9,2,3,5,1,6,7,4,7
22200037,False,POR,14400,106,43,30,13,14,2,11,24,3,1,4,2,4,5,2,6
22200038,True,ATL,14400,109,54,37,17,16,1,10,20,0,1,1,2,3,5,2,5
22200038,False,CHA,14400,126,47,25,22,19,0,14,33,2,4,6,1,11,8,5,12
22200039,True,CLE,15900,117,55,38,17,12,1,11,28,4,3,7,2,5,7,5,7
22200039,False,WAS,15900,107,56,38,18,19,0,11,23,0,1,1,0,5,4,0,5
22200040,True,NOP,15900,121,65,37,28,13,1,8,18,3,1,4,1,12,9,4,13
22200040,False,UTA,15900,122,54,41,13,13,1,4,9,4,5,9,0,3,0,0,3
22200041,True,OKC,14400,106,55,33,22,15,3,4,8,5,5,10,0,6,6,4,6
22200041,False,MIN,14400,116,48,24,24,17,0,6,12,2,1,3,0,7,7,3,7
22200042,True,GSW,14400,130,64,35,29,10,0,15,40,1,5,6,0,9,9,4,9
22200042,False,SAC,14400,125,51,24,27,17,0,7,16,1,5,6,0,3,3,2,3
22200043,True,LAC,14400,95,45,25,20,25,1,3,8,3,1,4,1,6,7,2,7
22200043,False,PHX,14400,112,54,35,19,17,0,1,2,3,2,5,1,7,8,5,8
22200044,True,PHI,14400,120,45,23,22,17,2,6,15,2,3,5,3,9,9,6,12
22200044,False,IND,14400,106,49,26,23,15,0,9,21,2,1,3,4,7,11,9,11
22200045,True,MIA,14400,90,48,33,15,13,3,6,13,4,3,7,3,12,10,6,15
22200045,False,TOR,14400,98,52,33,19,19,0,4,9,1,1,2,2,13,15,8,15
22200046,True,NYK,14400,115,50,28,22,20,0,11,27,2,2,4,5,19,21,7,24
22200046,False,ORL,14400,102,43,20,23,13,1,9,19,0,3,3,2,10,11,4,12
22200047,True,CHI,14400,120,64,30,34,21,0,11,24,1,0,1,2,4,6,5,6
22200047,False,BOS,14400,102,50,39,11,8,1,6,15,2,3,5,0,3,3,0,3
22200048,True,HOU,14400,114,56,35,21,12,1,4,9,1,1,2,3,4,7,6,7
22200048,False,UTA,14400,108,64,37,27,14,0,7,16,2,3,5,2,2,3,3,4
22200049,True,MEM,14400,134,63,41,22,7,0,14,35,3,3,6,1,3,4,3,4
22200049,False,BKN,14400,124,54,31,23,8,0,20,43,1,4,5,1,4,5,3,5
22200050,True,MIN,14400,106,53,34,19,14,0,13,31,2,2,4,0,3,3,0,3
22200050,False,SAS,14400,115,51,34,17,23,1,9,19,3,2,5,1,3,4,2,4
22200051,True,POR,14400,135,48,29,19,15,2,16,42,0,0,0,1,2,3,3,3
22200051,False,DEN,14400,110,46,21,25,13,0,8,19,3,3,6,0,7,5,1,7
22200052,True,WAS,14400,120,47,31,16,17,1,6,12,1,1,2,0,17,17,9,17
22200052,False,DET,14400,99,42,24,18,12,0,8,16,3,2,5,4,4,8,4,8
22200053,True,NOP,14400,113,49,21,28,16,0,6,14,2,5,7,0,3,1,0,3
22200053,False,DAL,14400,111,34,22,12,12,1,14,32,4,5,9,2,3,4,2,5
22200054,True,OKC,14400,108,57,39,18,15,3,3,6,0,4,4,1,2,3,1,3
22200054,False,LAC,14400,94,62,50,12,15,0,10,21,1,4,5,1,6,7,2,7
22200055,True,PHX,14400,134,45,24,21,11,0,11,27,4,4,8,0,6,6,5,6
22200055,False,GSW,14400,105,63,40,23,14,0,7,17,2,5,7,0,5,4,3,5
22200056,True,CLE,14400,103,46,31,15,11,2,3,6,3,3,6,1,11,12,6,12
22200056,False,ORL,14400,92,47,26,21,15,0,14,29,5,4,9,2,5,7,6,7
22200057,True,DET,14400,113,51,34,17,12,0,15,35,0,1,1,1,4,3,1,5
22200057,False,ATL,14400,118,60,42,18,10,1,15,31,1,0,1,2,4,4,4,6
22200058,True,NYK,15900,134,58,39,19,16,1,17,38,2,1,3,3,3,5,4,6
22200058,False,CHA,15900,131,54,38,16,13,1,15,33,1,3,4,1,9,7,5,10
22200059,True,TOR,14400,119,44,18,26,23,0,6,14,1,3,4,1,5,6,0,6
22200059,False,PHI,14400,109,50,27,23,11,2,5,12,1,2,3,0,15,14,2,15
22200060,True,MIL,14400,110,51,40,11,13,0,2,4,1,1,2,1,4,5,2,5
22200060,False,BKN,14400,99,56,33,23,13,0,14,31,1,1,2,0,13,13,3,13
22200061,True,CHI,14400,124,57,28,29,20,2,6,15,4,5,9,1,6,6,3,7
22200061,False,IND,14400,109,60,36,24,17,3,4,9,3,2,5,0,2,2,1,2
22200062,True,MIN,14400,134,59,33,26,18,0,8,20,1,2,3,0,4,4,2,4
22200062,False,SAS,14400,122,54,30,24,14,0,10,24,3,1,4,2,6,8,3,8
22200063,True,UTA,14400,109,49,32,17,16,0,3,8,2,3,5,1,8,9,6,9
22200063,False,HOU,14400,101,46,24,22,14,1,8,21,3,3,6,1,8,9,4,9
22200064,True,DEN,14400,110,44,27,17,19,0,5,10,2,5,7,0,1,1,1,1
22200064,False,LAL,14400,99,44,27,17,16,1,8,18,1,1,2,2,3,5,5,5
22200065,True,POR,14400,98,43,21,22,16,2,7,17,0,1,1,1,4,5,5,5
22200065,False,MIA,14400,119,38,18,20,18,0,3,6,1,0,1,0,1,1,0,1
22200066,True,BKN,15900,125,43,20,23,16,0,9,22,6,3,9,1,6,7,4,7
22200066,False,DAL,15900,129,64,43,21,21,0,6,15,2,2,4,0,8,6,3,8
22200067,True,OKC,14400,118,49,32,17,14,1,9,23,1,2,3,1,7,6,1,8
22200067,False,LAC,14400,110,41,30,11,15,1,7,15,2,2,4,0,7,7,1,7
22200068,True,GSW,14400,123,69,35,34,9,0,9,25,1,0,1,3,2,4,4,5
22200068,False,MIA,14400,110,63,25,38,16,0,8,18,3,3,6,2,3,2,0,5
22200069,True,SAC,14400,110,53,34,19,16,0,7,15,4,3,7,0,3,3,2,3
22200069,False,MEM,14400,125,45,27,18,17,1,12,28,2,2,4,4,7,11,7,11
22200070,True,DET,14400,112,64,44,20,7,0,12,25,3,1,4,2,16,14,7,18
22200070,False,ATL,14400,136,48,31,17,9,2,15,32,3,1,4,2,11,8,3,13
22200071,True,ORL,14400,113,52,29,23,21,0,7,17,2,2,4,0,10,9,2,10
22200071,False,CHA,14400,93,48,23,25,11,0,4,11,1,2,3,1,2,3,2,3
22200072,True,BOS,15900,123,51,27,24,13,1,9,20,3,5,8,0,8,4,2,8
22200072,False,CLE,15900,132,50,26,24,14,2,13,31,3,4,7,1,4,4,4,5
22200073,True,TOR,14400,90,44,22,22,11,0,3,7,3,5,8,0,1,1,1,1
22200073,False,PHI,14400,112,52,21,31,11,2,4,9,1,5,6,0,6,5,4,6
22200074,True,WAS,14400,117,46,31,15,12,0,5,10,2,2,4,1,3,3,1,4
22200074,False,IND,14400,127,50,28,22,14,2,8,19,1,1,2,0,2,2,1,2
22200075,True,MIL,14400,119,63,41,22,14,0,5,12,2,2,4,2,1,3,2,3
22200075,False,NYK,14400,108,58,32,26,16,0,5,10,1,2,3,0,11,6,2,11
22200076,True,MIN,14400,111,55,34,21,20,0,4,10,1,2,3,2,3,5,5,5
22200076,False,LAL,14400,102,61,35,26,10,0,5,13,4,1,5,0,5,4,1,5
22200077,True,SAS,14400,129,72,51,21,8,1,6,13,4,2,6,1,2,3,1,3
22200077,False,CHI,14400,124,58,26,32,23,1,10,22,3,6,9,3,2,5,4,5
22200078,True,DEN,14400,117,43,30,13,7,0,6,15,0,0,0,4,4,8,6,8
22200078,False,UTA,14400,101,41,26,15,8,0,7,18,4,4,8,1,3,4,3,4
22200079,True,PHX,14400,124,51,29,22,16,0,9,18,5,4,9,2,7,8,4,9
22200079,False,NOP,14400,111,47,25,22,25,1,5,12,4,2,6,3,3,6,4,6
22200080,True,POR,14400,125,53,32,21,22,0,9,23,5,2,7,2,7,9,7,9
22200080,False,HOU,14400,111,48,24,24,20,1,5,11,5,3,8,3,7,10,5,10
22200081,True,SAC,14400,119,41,31,10,10,1,12,32,0,2,2,1,12,13,3,13
22200081,False,MIA,14400,113,32,20,12,14,1,11,29,2,3,5,0,11,10,4,11
22200082,True,CHA,15900,120,43,21,22,10,0,12,28,2,2,4,2,3,4,3,5
22200082,False,GSW,15900,113,61,40,21,21,1,17,39,3,1,4,1,4,5,3,5
22200083,True,BKN,14400,116,54,29,25,10,0,11,29,1,3,4,1,2,3,2,3
22200083,False,IND,14400,125,38,21,17,13,0,7,18,1,1,2,0,3,3,2,3
22200084,True,CHI,14400,109,43,21,22,15,0,8,18,2,0,2,0,3,3,1,3
22200084,False,PHI,14400,114,39,22,17,18,2,4,10,0,1,1,0,2,2,1,2
22200085,True,MIL,14400,123,53,36,17,16,0,8,19,5,1,6,4,7,11,8,11
22200085,False,ATL,14400,115,54,33,21,14,1,18,42,2,2,4,3,9,12,7,12
22200086,True,DAL,15900,111,63,43,20,20,0,6,14,6,6,12,2,7,7,4,9
22200086,False,OKC,15900,117,62,31,31,18,2,4,8,4,6,10,0,10,6,1,10
22200087,True,UTA,14400,124,38,28,10,10,0,7,18,3,1,4,0,6,2,1,6
22200087,False,MEM,14400,123,38,16,22,18,0,13,31,0,5,5,1,5,4,1,6
22200088,True,LAC,14400,91,47,33,14,12,1,11,25,2,4,6,3,12,12,4,15
22200088,False,NOP,14400,112,39,23,16,20,1,7,18,1,1,2,1,5,6,2,6
22200089,True,BOS,14400,112,56,41,15,8,1,8,21,2,2,4,1,6,7,2,7
22200089,False,WAS,14400,94,46,23,23,8,0,7,16,7,2,9,0,3,3,0,3
22200090,True,CLE,14400,121,61,44,17,7,2,9,22,2,0,2,0,3,3,0,3
22200090,False,NYK,14400,108,54,27,27,18,0,5,12,4,0,4,1,2,3,1,3
22200091,True,DET,14400,128,63,33,30,12,1,5,12,3,2,5,2,6,5,4,8
22200091,False,GSW,14400,114,58,35,23,20,1,13,32,5,1,6,0,6,4,0,6
22200092,True,SAS,14400,107,57,47,10,12,0,5,11,2,3,5,2,9,11,8,11
22200092,False,MIN,14400,98,42,22,20,21,2,9,18,2,7,9,0,6,6,4,6
22200093,True,DAL,14400,114,63,41,22,16,0,6,13,3,4,7,1,2,2,0,3
22200093,False,ORL,14400,105,60,33,27,7,0,6,13,3,0,3,2,5,6,3,7
22200094,True,PHX,14400,124,49,35,14,33,0,8,17,0,2,2,1,3,4,3,4
22200094,False,HOU,14400,109,42,20,22,22,0,3,7,0,3,3,2,4,5,3,6
22200095,True,LAL,14400,121,63,32,31,16,0,3,6,0,0,0,3,3,6,4,6
22200095,False,DEN,14400,110,58,38,20,12,0,7,18,2,0,2,1,2,3,3,3
22200096,True,CHA,14400,108,42,26,16,21,0,12,28,0,4,4,0,8,5,4,8
22200096,False,SAC,14400,115,49,30,19,11,0,9,21,3,5,8,3,4,7,6,7
22200097,True,WAS,14400,111,50,32,18,17,2,10,22,4,5,9,1,1,2,1,2
22200097,False,PHI,14400,118,39,22,17,22,0,11,25,0,4,4,2,7,7,2,9
22200098,True,BKN,14400,116,48,26,22,22,0,7,15,1,6,7,1,9,8,3,10
22200098,False,IND,14400,109,46,25,21,19,1,12,29,2,4,6,0,5,5,1,5
22200099,True,TOR,14400,139,52,27,25,18,0,11,25,0,1,1,1,3,4,1,4
22200099,False,ATL,14400,109,56,31,25,9,0,5,13,4,1,5,0,7,6,3,7
22200100,True,MIL,14400,110,60,39,21,12,0,5,13,4,5,9,1,7,8,5,8
22200100,False,DET,14400,108,53,26,27,18,1,17,37,3,3,6,0,8,5,2,8
22200101,True,UTA,14400,121,41,30,11,11,0,13,34,2,0,2,0,14,14,4,14
22200101,False,MEM,14400,105,32,16,16,16,1,12,28,3,2,5,0,7,7,2,7
22200102,True,LAC,14400,95,59,43,16,18,1,5,13,1,3,4,1,5,6,3,6
22200102,False,HOU,14400,93,59,37,22,22,0,7,18,3,3,6,5,6,10,7,11
22200103,True,BKN,14400,99,59,49,10,17,0,3,8,3,2,5,0,7,7,3,7
22200103,False,CHI,14400,108,34,22,12,22,1,11,25,2,2,4,0,3,3,3,3
22200104,True,MIA,14400,116,49,21,28,12,2,11,29,2,2,4,1,7,6,3,8
22200104,False,GSW,14400,109,60,31,29,8,1,9,22,3,5,8,2,3,4,1,5
22200105,True,OKC,14400,116,61,43,18,22,0,3,7,5,2,7,0,4,4,0,4
22200105,False,ORL,14400,108,46,30,16,11,0,6,13,1,2,3,0,2,2,0,2
22200106,True,PHX,14400,116,57,35,22,22,0,9,21,5,2,7,0,4,2,1,4
22200106,False,MIN,14400,107,54,27,27,21,0,6,15,6,3,9,0,6,5,0,6
22200107,True,CLE,15900,114,58,34,24,15,0,5,12,2,4,6,0,4,3,3,4
22200107,False,BOS,15900,113,60,35,25,7,1,6,14,1,6,7,1,9,8,4,10
22200108,True,PHI,14400,111,39,24,15,8,1,7,20,4,2,6,0,7,7,2,7
22200108,False,WAS,14400,121,48,27,21,19,0,4,9,0,4,4,0,1,1,0,1
22200109,True,MIA,14400,110,34,14,20,11,0,17,39,1,0,1,2,7,7,1,9
22200109,False,SAC,14400,107,45,26,19,7,3,9,20,1,0,1,0,4,4,1,4
22200110,True,NYK,14400,99,65,41,24,13,0,5,11,2,2,4,0,4,3,2,4
22200110,False,ATL,14400,112,43,25,18,12,0,11,22,4,2,6,3,4,5,3,7
22200111,True,CHI,14400,106,55,34,21,21,0,11,25,2,2,4,1,4,5,3,5
22200111,False,CHA,14400,88,58,34,24,19,0,6,15,0,1,1,1,1,2,2,2
22200112,True,HOU,14400,101,57,34,23,20,0,6,15,2,0,2,5,2,7,6,7
22200112,False,LAC,14400,109,48,27,21,19,0,9,21,2,2,4,2,6,8,6,8
22200113,True,MIL,14400,116,42,32,10,21,0,3,8,1,5,6,2,6,8,5,8
22200113,False,DET,14400,91,50,32,18,10,0,12,29,1,2,3,0,8,8,6,8
22200114,True,SAS,14400,100,51,37,14,13,0,2,5,4,1,5,0,3,3,1,3
22200114,False,TOR,14400,143,52,28,24,28,1,6,15,2,2,4,0,3,3,2,3
22200115,True,DAL,14400,103,54,34,20,19,0,7,16,2,3,5,2,4,6,4,6
22200115,False,UTA,14400,100,49,27,22,10,0,5,12,1,0,1,0,3,3,1,3
22200116,True,POR,14400,106,38,28,10,13,0,7,16,3,2,5,2,2,1,0,4
22200116,False,MEM,14400,111,45,29,16,15,1,12,27,2,4,6,1,1,2,2,2
22200117,True,LAL,15900,120,55,40,15,17,2,2,5,2,4,6,1,0,1,1,1
22200117,False,NOP,15900,117,46,23,23,30,1,7,14,2,3,5,1,4,4,1,5
22200118,True,ORL,14400,130,55,27,28,13,0,10,22,1,4,5,3,9,11,8,12
22200118,False,GSW,14400,129,54,34,20,16,2,17,43,3,1,4,2,9,11,6,11
22200119,True,OKC,14400,110,48,30,18,14,0,3,6,7,4,11,0,1,1,0,1
22200119,False,DEN,14400,122,48,27,21,16,1,7,15,5,5,10,0,3,3,1,3
22200120,True,DET,14400,88,38,29,9,23,0,9,21,2,2,4,0,3,3,0,3
22200120,False,CLE,14400,112,46,32,14,9,1,8,20,3,5,8,3,8,8,7,11
22200121,True,IND,14400,101,53,28,25,11,1,6,14,0,3,3,1,3,4,1,4
22200121,False,MIA,14400,99,48,20,28,15,0,8,19,4,6,10,0,7,5,1,7
22200122,True,PHI,14400,104,36,23,13,16,1,9,21,2,1,3,2,6,8,4,8
22200122,False,NYK,14400,106,54,31,23,10,0,4,9,1,2,3,4,6,10,5,10
22200123,True,WAS,14400,86,41,24,17,6,0,6,14,0,1,1,1,2,2,0,3
22200123,False,BKN,14400,128,58,31,27,10,0,6,13,4,0,4,0,4,4,1,4
22200124,True,BOS,14400,123,46,32,14,11,1,10,24,7,5,12,0,5,4,0,5
22200124,False,CHI,14400,119,49,30,19,15,1,12,24,3,2,5,1,3,3,1,4
22200125,True,MEM,14400,130,45,30,15,10,0,16,37,4,3,7,2,4,6,2,6
22200125,False,CHA,14400,99,44,27,17,21,0,10,22,0,3,3,1,4,4,1,5
22200126,True,SAS,14400,106,47,28,19,8,0,10,21,4,1,5,0,3,2,2,3
22200126,False,LAC,14400,113,56,34,22,11,0,10,25,0,2,2,0,4,1,1,4
22200127,True,DAL,14400,111,56,36,20,17,2,3,6,1,1,2,0,2,2,1,2
22200127,False,TOR,14400,110,48,28,20,23,1,5,12,2,0,2,6,0,5,5,6
22200128,True,NOP,14400,114,45,20,25,20,1,8,21,1,5,6,1,3,3,0,4
22200128,False,GSW,14400,105,53,35,18,15,0,4,10,3,1,4,0,5,5,3,5
22200129,True,MIN,14400,102,56,32,24,19,0,14,33,5,3,8,1,7,8,4,8
22200129,False,MIL,14400,115,59,30,29,15,0,4,8,2,1,3,1,2,3,1,3
22200130,True,PHX,14400,106,53,37,16,14,1,3,7,1,5,6,2,3,4,2,5
22200130,False,POR,14400,108,51,29,22,13,0,4,9,3,2,5,1,5,2,1,6
22200131,True,LAL,14400,116,53,37,16,17,0,5,12,3,3,6,1,3,4,1,4
22200131,False,UTA,14400,130,35,27,8,10,0,7,16,1,1,2,1,4,3,3,5
22200132,True,ORL,15900,123,51,32,19,14,0,12,24,3,3,6,1,8,7,4,9
22200132,False,SAC,15900,126,54,44,10,10,1,11,27,3,1,4,3,5,8,4,8
22200133,True,CHA,14400,94,43,27,16,15,0,4,11,1,2,3,2,2,4,1,4
22200133,False,BKN,14400,98,55,27,28,13,0,11,25,2,2,4,0,6,5,3,6
22200134,True,ATL,15900,124,58,47,11,18,2,6,13,1,4,5,0,6,6,1,6
22200134,False,NOP,15900,121,50,32,18,17,0,13,30,4,3,7,2,8,10,5,10
22200135,True,NYK,14400,118,44,25,19,6,0,1,2,2,3,5,1,5,4,2,6
22200135,False,BOS,14400,133,44,37,7,10,0,12,33,0,2,2,1,7,8,3,8
22200136,True,MIL,14400,108,49,25,24,17,0,6,17,3,3,6,1,3,2,2,4
22200136,False,OKC,14400,94,65,29,36,14,1,6,13,3,4,7,1,5,5,3,6
22200137,True,MIN,14400,129,58,29,29,38,0,8,20,4,3,7,2,2,4,3,4
22200137,False,HOU,14400,117,38,18,20,29,1,6,15,3,3,6,1,2,3,2,3
22200138,True,DEN,14400,126,46,23,23,16,0,12,30,2,5,7,1,3,4,4,4
22200138,False,SAS,14400,101,58,37,21,13,0,6,14,1,2,3,0,3,2,1,3
22200139,True,PHX,14400,102,54,45,9,20,0,3,7,3,2,5,1,2,3,3,3
22200139,False,POR,14400,82,58,35,23,14,0,3,8,4,1,5,0,6,6,3,6
22200140,True,LAL,14400,100,46,28,18,16,1,3,6,1,0,1,3,7,10,8,10
22200140,False,CLE,14400,114,49,31,18,16,2,8,19,2,3,5,2,11,13,9,13
22200141,True,TOR,14400,113,45,25,20,17,0,9,21,8,4,12,3,1,3,3,4
22200141,False,CHI,14400,104,51,34,17,12,2,4,9,5,5,10,0,8,8,4,8
22200142,True,MEM,14400,103,56,29,27,15,0,13,28,1,2,3,1,5,6,3,6
22200142,False,WAS,14400,97,62,41,21,7,0,9,20,3,1,4,3,3,6,3,6
22200143,True,LAC,14400,102,47,18,29,21,0,7,18,3,3,6,0,6,6,4,6
22200143,False,UTA,14400,110,55,35,20,13,1,8,19,2,2,4,0,2,2,1,2
22200144,True,CHA,14400,100,47,35,12,24,0,5,10,2,3,5,2,1,3,3,3
22200144,False,WAS,14400,108,59,36,23,17,0,11,23,4,1,5,0,7,6,2,7
22200145,True,ORL,14400,127,43,13,30,15,0,10,23,5,2,7,0,6,3,1,6
22200145,False,HOU,14400,134,32,24,8,13,0,9,23,3,2,5,1,2,3,2,3
22200146,True,DET,14400,112,50,37,13,8,0,11,24,4,3,7,2,6,8,4,8
22200146,False,OKC,14400,103,41,27,14,13,0,5,12,4,3,7,1,9,10,3,10
22200147,True,IND,14400,129,52,40,12,7,0,6,17,7,3,10,0,5,5,3,5
22200147,False,NOP,14400,122,39,15,24,15,1,8,19,3,1,4,1,5,5,3,6
22200148,True,PHI,14400,100,42,31,11,13,0,4,9,5,5,10,3,10,13,11,13
22200148,False,PHX,14400,88,41,28,13,15,0,9,19,4,2,6,2,3,4,4,5
22200149,True,ATL,14400,117,49,24,25,18,1,23,53,2,7,9,0,8,4,0,8
22200149,False,MIL,14400,98,70,49,21,11,0,9,22,0,1,1,0,3,3,1,3
22200150,True,MIA,14400,107,24,11,13,19,2,5,13,1,2,3,1,8,9,4,9
22200150,False,POR,14400,110,40,22,18,11,1,6,14,0,1,1,0,2,2,0,2
22200151,True,CHI,14400,111,51,34,17,17,1,1,3,4,4,8,0,13,9,6,13
22200151,False,TOR,14400,97,47,26,21,17,1,6,14,3,3,6,1,3,3,2,4
22200152,True,MEM,14400,106,54,30,24,15,1,5,11,2,1,3,1,9,9,4,10
22200152,False,BOS,14400,109,54,27,27,7,2,5,12,2,3,5,0,8,8,1,8
22200153,True,MIN,14400,107,48,22,26,15,0,3,8,0,0,0,1,4,5,3,5
22200153,False,NYK,14400,120,43,20,23,16,0,5,12,3,2,5,0,2,2,0,2
22200154,True,SAS,14400,109,50,32,18,23,1,11,27,0,5,5,0,2,2,1,2
22200154,False,DEN,14400,115,44,25,19,20,0,13,28,1,4,5,0,0,0,0,0
22200155,True,DAL,14400,96,46,31,15,21,0,5,12,5,3,8,1,1,2,2,2
22200155,False,BKN,14400,94,49,26,23,17,0,5,10,5,3,8,3,12,14,7,15
22200156,True,GSW,14400,116,51,29,22,10,0,13,35,2,0,2,1,5,6,2,6
22200156,False,SAC,14400,113,40,25,15,15,0,9,23,4,1,5,1,2,3,3,3
22200157,True,UTA,14400,139,40,31,9,19,0,15,36,2,1,3,1,1,2,1,2
22200157,False,LAL,14400,116,47,26,21,14,1,7,16,3,1,4,2,4,6,4,6
22200158,True,LAC,14400,119,37,25,12,14,0,12,27,0,2,2,2,3,5,3,5
22200158,False,CLE,14400,117,45,24,21,12,0,9,23,2,0,2,0,3,3,2,4
22200159,True,CHA,14400,95,31,18,13,21,0,6,14,3,1,4,5,1,5,4,6
22200159,False,POR,14400,105,50,25,25,19,2,7,17,0,4,4,1,7,8,4,8
22200160,True,IND,14400,119,45,35,10,14,1,7,15,2,6,8,1,3,4,2,4
22200160,False,DEN,14400,122,51,32,19,14,0,6,15,5,6,11,1,3,3,2,4
22200161,True,ORL,14400,94,46,21,25,6,0,8,18,0,0,0,0,8,8,5,8
22200161,False,DAL,14400,87,36,28,8,16,1,4,10,0,1,1,0,3,3,2,3
22200162,True,ATL,14400,119,55,31,24,8,2,17,35,3,1,4,1,6,7,3,7
22200162,False,UTA,14400,125,39,28,11,14,0,10,25,0,1,1,0,2,2,0,2
22200163,True,BOS,14400,128,48,33,15,6,1,12,28,4,1,5,0,8,4,2,8
22200163,False,DET,14400,112,47,18,29,10,0,4,8,3,1,4,0,2,2,1,2
22200164,True,BKN,14400,112,47,30,17,11,0,7,18,5,2,7,1,6,6,3,7
22200164,False,NYK,14400,85,48,36,12,13,1,6,13,3,1,4,2,2,3,0,4
22200165,True,TOR,14400,116,50,29,21,16,0,12,30,3,4,7,0,5,5,1,5
22200165,False,HOU,14400,109,68,41,27,14,2,5,10,0,3,3,0,6,6,5,6
22200166,True,CHI,14400,111,45,38,7,16,1,9,18,1,2,3,1,3,4,4,4
22200166,False,NOP,14400,115,37,27,10,16,0,5,10,4,1,5,2,5,7,5,7
22200167,True,MIN,14400,117,45,31,14,10,0,8,21,2,0,2,0,3,3,1,3
22200167,False,PHX,14400,129,32,20,12,13,0,14,31,2,3,5,0,3,3,1,3
22200168,True,OKC,17400,132,75,48,27,18,1,11,24,3,2,5,1,9,8,3,10
22200168,False,MIL,17400,136,68,41,27,13,0,13,29,0,2,2,3,8,11,2,11
22200169,True,SAS,15900,122,47,36,11,23,0,11,24,3,4,7,1,3,4,2,4
22200169,False,MEM,15900,124,51,26,25,7,1,16,39,4,1,5,0,10,9,2,10
22200170,True,LAC,14400,114,53,33,20,9,0,11,24,1,1,2,3,3,6,4,6
22200170,False,LAL,14400,101,47,27,20,23,0,7,17,1,3,4,2,1,3,0,3
22200171,True,SAC,14400,127,47,32,15,16,0,6,14,1,4,5,1,2,3,3,3
22200171,False,CLE,14400,120,45,23,22,11,1,11,25,2,1,3,0,4,4,2,4
22200172,True,WAS,14400,113,43,16,27,10,0,8,18,3,0,3,0,7,6,1,7
22200172,False,DAL,14400,105,37,24,13,11,1,7,19,3,3,6,2,3,4,0,5
22200173,True,ATL,14400,104,44,26,18,13,2,10,21,3,2,5,1,8,6,2,9
22200173,False,PHI,14400,95,45,29,16,12,1,5,13,2,4,6,0,7,7,2,7
22200174,True,MIA,15900,117,61,30,31,18,2,4,9,4,3,7,1,7,8,3,8
22200174,False,CHA,15900,112,59,37,22,18,0,10,23,1,2,3,1,3,4,2,4
22200175,True,NOP,14400,95,37,28,9,10,1,6,13,2,2,4,1,3,4,3,4
22200175,False,POR,14400,106,32,26,6,5,2,2,6,3,1,4,0,1,1,0,1
22200176,True,BOS,14400,131,60,40,20,10,0,16,37,3,1,4,2,10,10,6,12
22200176,False,DEN,14400,112,39,22,17,6,1,6,14,1,1,2,1,2,3,1,3
22200177,True,ORL,14400,114,54,26,28,5,0,13,28,1,2,3,1,4,5,2,5
22200177,False,PHX,14400,97,43,21,22,19,0,10,26,2,3,5,1,3,3,2,4
22200178,True,NYK,14400,121,43,24,19,15,1,7,16,5,3,8,1,11,8,4,12
22200178,False,DET,14400,112,56,32,24,13,0,8,17,4,2,6,0,5,5,2,5
22200179,True,OKC,14400,132,59,37,22,15,1,3,6,8,2,10,1,8,6,2,9
22200179,False,TOR,14400,113,47,29,18,19,0,8,19,2,1,3,2,3,5,3,5
22200180,True,SAS,14400,111,45,33,12,12,0,12,28,1,1,2,2,13,13,6,15
22200180,False,MIL,14400,93,42,28,14,9,0,6,13,6,3,9,2,5,6,4,7
22200181,True,MEM,14400,114,40,24,16,9,0,17,39,2,3,5,1,5,6,3,6
22200181,False,MIN,14400,103,41,24,17,14,0,11,24,0,2,2,3,7,10,7,10
22200182,True,GSW,14400,106,53,35,18,20,0,10,26,3,1,4,0,16,14,8,16
22200182,False,CLE,14400,101,35,18,17,8,0,5,11,3,2,5,2,4,6,1,6
22200183,True,LAL,14400,114,54,30,24,17,0,8,17,2,0,2,1,2,3,2,3
22200183,False,SAC,14400,120,60,40,20,12,0,13,30,0,3,3,1,2,3,2,3
22200184,True,LAC,14400,95,37,23,14,20,0,10,23,3,1,4,3,7,10,6,10
22200184,False,BKN,14400,110,47,34,13,22,0,10,25,1,3,4,0,6,5,3,6
22200185,True,WAS,14400,121,53,31,22,12,0,5,12,1,6,7,0,7,6,1,7
22200185,False,UTA,14400,112,46,29,17,12,2,10,22,0,0,0,0,5,5,2,5
22200186,True,DET,14400,108,52,22,30,9,0,10,23,2,2,4,0,4,4,2,4
22200186,False,BOS,14400,117,48,32,16,10,2,7,16,3,3,6,0,6,6,3,6
22200187,True,IND,14400,118,52,30,22,10,0,5,12,2,5,7,1,8,6,2,9
22200187,False,TOR,14400,104,41,22,19,13,2,6,12,3,1,4,0,3,3,2,3
22200188,True,PHI,14400,121,44,33,11,11,1,13,29,1,2,3,0,3,3,2,3
22200188,False,ATL,14400,109,32,23,9,8,1,8,18,3,0,3,1,1,2,1,2
22200189,True,MIA,14400,132,38,21,17,11,1,9,22,1,1,2,0,5,5,2,5
22200189,False,CHA,14400,115,37,21,16,8,0,15,33,1,1,2,1,1,2,1,2
22200190,True,DAL,14400,117,47,31,16,9,0,5,11,0,6,6,1,6,6,3,7
22200190,False,POR,14400,112,39,17,22,7,0,10,22,4,3,7,0,5,3,3,5
22200191,True,NOP,14400,119,40,17,23,23,0,4,9,3,4,7,1,9,8,4,10
22200191,False,HOU,14400,106,34,25,9,19,2,10,22,3,0,3,0,2,2,0,2
22200192,True,NYK,14400,135,41,25,16,15,0,12,26,4,1,5,3,2,4,4,5
22200192,False,OKC,14400,145,43,29,14,17,1,13,29,1,0,1,0,4,4,1,4
22200193,True,CLE,14400,124,45,30,15,8,1,14,36,3,1,4,0,4,4,2,4
22200193,False,MIN,14400,129,48,35,13,9,0,13,31,2,1,3,0,3,3,0,3
22200194,True,WAS,14400,102,52,40,12,21,0,9,21,1,4,5,1,2,3,2,3
22200194,False,MEM,14400,92,45,25,20,11,1,14,28,1,2,3,1,0,1,1,1
22200195,True,PHI,14400,105,49,27,22,19,0,7,14,4,2,6,0,10,9,1,10
22200195,False,UTA,14400,98,37,32,5,11,1,7,16,6,0,6,0,1,1,1,1
22200196,True,CHI,14400,103,39,24,15,11,0,8,17,4,3,7,1,2,3,1,3
22200196,False,DEN,14400,126,40,31,9,9,0,15,32,0,1,1,1,1,2,0,2
22200197,True,SAC,14400,122,52,24,28,17,0,8,21,2,5,7,1,3,4,4,4
22200197,False,GSW,14400,115,62,38,24,15,1,7,17,3,3,6,1,3,4,2,4
22200198,True,LAL,14400,116,43,31,12,8,1,3,6,1,0,1,3,1,4,4,4
22200198,False,BKN,14400,103,58,39,19,10,0,5,10,0,1,1,1,6,7,2,7
22200199,True,DET,14400,111,55,38,17,16,1,2,4,4,3,7,0,13,8,5,13
22200199,False,TOR,14400,115,47,33,14,20,1,5,13,5,4,9,0,7,6,1,7
22200200,True,ORL,14400,105,54,28,26,20,0,12,28,5,0,5,5,6,11,7,11
22200200,False,CHA,14400,112,47,28,19,24,0,10,24,3,3,6,2,2,4,4,4
22200201,True,BOS,14400,126,52,33,19,25,0,9,19,2,2,4,1,12,13,4,13
22200201,False,OKC,14400,122,50,31,19,19,2,12,26,2,2,4,0,6,6,1,6
22200202,True,MIA,14400,113,58,32,26,11,1,10,22,2,0,2,1,6,5,1,7
22200202,False,PHX,14400,112,47,26,21,10,0,15,35,3,2,5,1,2,3,1,3
22200203,True,HOU,14400,106,44,21,23,21,0,7,17,4,3,7,2,0,2,0,2
22200203,False,LAC,14400,122,58,36,22,17,0,13,27,1,3,4,1,1,2,1,2
22200204,True,MIL,14400,106,47,38,9,2,0,7,14,1,1,2,0,4,4,2,4
22200204,False,ATL,14400,121,48,31,17,7,2,13,28,1,3,4,0,5,5,1,5
22200205,True,GSW,14400,132,61,37,24,20,0,10,27,0,3,3,1,1,2,1,2
22200205,False,SAS,14400,95,33,15,18,9,0,8,19,2,1,3,3,1,4,3,4
22200206,True,NOP,14400,113,55,33,22,13,0,15,39,2,4,6,3,17,19,9,20
22200206,False,MEM,14400,102,50,34,16,9,0,8,19,3,1,4,4,4,8,5,8
22200207,True,DAL,14400,103,50,32,18,16,0,6,14,1,0,1,0,6,4,0,6
22200207,False,LAC,14400,101,43,21,22,11,0,6,12,4,2,6,0,4,4,1,4
22200208,True,UTA,14400,111,59,41,18,12,1,4,12,3,3,6,0,3,3,1,3
22200208,False,NYK,14400,118,47,20,27,10,1,8,18,4,4,8,1,7,7,5,8
22200209,True,POR,14400,117,43,26,17,14,0,2,5,4,2,6,0,3,3,1,3
22200209,False,SAS,14400,110,42,25,17,27,0,2,6,2,2,4,1,6,7,3,7
22200210,True,SAC,14400,153,48,29,19,11,0,8,20,4,3,7,2,2,4,2,4
22200210,False,BKN,14400,121,34,19,15,12,0,10,22,1,4,5,0,8,5,1,8
22200211,True,CHA,14400,113,24,16,8,13,0,5,13,1,3,4,0,4,2,0,4
22200211,False,IND,14400,125,40,28,12,15,0,11,22,1,3,4,1,2,3,2,3
22200212,True,ORL,14400,108,53,24,29,11,0,15,35,1,2,3,2,6,8,4,8
22200212,False,MIN,14400,126,61,36,25,22,0,14,32,0,2,2,3,7,8,5,10
22200213,True,WAS,14400,120,47,35,12,12,1,7,15,5,2,7,1,3,3,2,4
22200213,False,OKC,14400,121,59,39,20,17,2,9,19,5,3,8,0,3,2,1,3
22200214,True,ATL,14400,101,49,22,27,11,1,14,30,3,2,5,1,4,4,3,5
22200214,False,BOS,14400,126,51,38,13,14,1,17,42,0,3,3,0,14,13,4,14
22200215,True,TOR,14400,112,30,12,18,11,0,11,25,2,0,2,6,0,5,2,6
22200215,False,MIA,14400,104,43,29,14,14,2,10,25,2,1,3,0,2,2,0,2
22200216,True,MIL,14400,113,58,40,18,10,0,7,17,0,3,3,0,4,4,1,4
22200216,False,CLE,14400,98,48,27,21,8,0,12,31,2,2,4,0,6,6,3,6
22200217,True,NOP,14400,124,51,28,23,14,1,14,34,0,2,2,1,2,3,2,3
22200217,False,CHI,14400,110,49,27,22,16,0,14,29,2,1,3,0,3,3,2,3
22200218,True,DAL,14400,92,35,25,10,9,1,8,20,1,3,4,0,11,9,1,11
22200218,False,HOU,14400,101,51,29,22,4,0,8,17,0,5,5,0,5,5,2,5
22200219,True,DEN,14400,103,53,27,26,10,0,6,15,1,0,1,1,2,3,1,3
22200219,False,NYK,14400,106,60,33,27,10,0,7,15,2,3,5,0,4,4,2,4
22200220,True,PHX,14400,130,43,22,21,11,1,6,13,2,1,3,1,4,4,2,5
22200220,False,GSW,14400,119,52,24,28,9,0,15,38,0,3,3,0,8,6,0,8
22200221,True,POR,14400,107,43,26,17,15,0,6,16,8,1,9,2,4,2,2,6
22200221,False,BKN,14400,109,64,41,23,14,0,7,16,4,0,4,0,7,3,1,7
22200222,True,SAC,14400,130,45,30,15,13,1,11,24,3,3,6,0,4,4,1,4
22200222,False,SAS,14400,112,43,33,10,21,1,12,27,2,2,4,2,6,8,3,8
22200223,True,LAC,14400,96,49,37,12,10,0,13,31,1,0,1,2,6,8,7,8
22200223,False,DET,14400,91,54,34,20,16,0,8,18,4,2,6,2,3,5,5,5
22200224,True,WAS,15900,107,67,33,34,11,0,7,18,5,5,10,1,11,9,4,12
22200224,False,MIA,15900,106,45,25,20,8,2,9,22,5,2,7,1,4,4,2,5
22200225,True,CLE,17400,132,69,44,25,10,0,15,33,4,6,10,1,5,5,5,6
22200225,False,CHA,17400,122,39,27,12,15,1,14,33,6,4,10,3,2,5,5,5
22200226,True,PHI,14400,110,49,30,19,11,0,12,28,4,0,4,2,10,10,4,12
22200226,False,MIL,14400,102,39,33,6,12,0,6,13,3,2,5,0,1,1,0,1
22200227,True,CHI,14400,107,50,28,22,12,1,8,16,2,3,5,0,7,6,5,7
22200227,False,ORL,14400,108,51,39,12,13,0,9,22,3,1,4,0,2,1,1,2
22200228,True,HOU,14400,91,38,17,21,9,1,2,4,2,1,3,1,7,8,4,8
22200228,False,IND,14400,99,45,32,13,16,1,3,7,3,3,6,0,4,2,2,4
22200229,True,MEM,14400,121,49,36,13,12,0,8,17,1,1,2,3,2,5,5,5
22200229,False,OKC,14400,110,50,28,22,7,0,5,12,2,5,7,0,0,0,0,0
22200230,True,DAL,14400,127,43,29,14,10,0,5,10,2,1,3,1,5,6,5,6
22200230,False,DEN,14400,99,36,16,20,14,1,4,9,1,2,3,0,1,1,1,1
22200231,True,NOP,14400,109,49,24,25,18,0,7,16,2,2,4,0,6,5,1,6
22200231,False,BOS,14400,117,49,32,17,12,0,6,15,2,0,2,0,4,4,2,4
22200232,True,UTA,14400,134,42,27,15,13,0,10,26,2,2,4,1,0,1,1,1
22200232,False,PHX,14400,133,47,31,16,15,0,11,24,0,4,4,2,2,4,4,4
22200233,True,GSW,14400,111,51,29,22,11,0,5,12,1,0,1,1,6,6,4,7
22200233,False,NYK,14400,101,43,26,17,10,0,4,9,3,1,4,2,1,3,3,3
22200234,True,LAL,14400,128,45,32,13,11,1,7,14,0,2,2,0,4,4,3,4
22200234,False,DET,14400,121,35,25,10,20,1,12,27,2,4,6,1,1,2,2,2
22200235,True,ATL,15900,124,62,39,23,16,0,5,11,3,2,5,0,6,4,3,6
22200235,False,TOR,15900,122,41,26,15,25,1,7,16,4,3,7,1,5,6,4,6
22200236,True,IND,14400,114,66,41,25,9,0,7,17,1,3,4,2,6,8,2,8
22200236,False,ORL,14400,113,62,30,32,14,1,12,30,1,3,4,0,6,3,2,6
22200237,True,PHI,14400,109,41,17,24,10,1,10,24,3,0,3,0,5,5,1,5
22200237,False,MIN,14400,112,36,14,22,14,1,12,28,2,1,3,0,4,4,2,4
22200238,True,POR,14400,113,58,35,23,18,0,9,23,2,1,3,0,3,3,1,3
22200238,False,UTA,14400,118,41,23,18,16,0,9,20,1,3,4,0,5,5,2,5
22200239,True,LAC,14400,119,46,31,15,10,0,6,14,3,4,7,0,4,2,0,4
22200239,False,SAS,14400,97,49,23,26,15,1,8,17,3,1,4,1,4,4,3,5
22200240,True,PHX,14400,116,43,29,14,14,0,7,15,2,2,4,5,8,13,8,13
22200240,False,NYK,14400,95,59,35,24,9,0,9,18,2,2,4,1,7,8,5,8
22200241,True,WAS,14400,106,63,41,22,9,0,10,22,1,0,1,1,3,4,2,4
22200241,False,CHA,14400,102,45,23,22,9,2,11,22,0,2,2,0,0,0,0,0
22200242,True,SAC,14400,137,51,31,20,17,0,9,21,1,0,1,1,4,5,3,5
22200242,False,DET,14400,129,52,26,26,17,0,12,27,1,1,2,3,1,4,3,4
22200243,True,BKN,14400,127,58,28,30,12,0,6,13,0,3,3,2,8,10,6,10
22200243,False,MEM,14400,115,54,29,25,21,0,2,4,0,2,2,1,1,2,1,2
22200244,True,CLE,14400,113,37,22,15,13,0,5,10,3,1,4,2,3,5,3,5
22200244,False,MIA,14400,87,23,14,9,14,0,6,15,4,1,5,0,4,4,1,4
22200245,True,HOU,14400,120,37,14,23,17,0,6,15,4,2,6,3,4,7,6,7
22200245,False,GSW,14400,127,59,31,28,17,0,12,35,3,2,5,1,9,9,2,10
22200246,True,DAL,14400,97,41,25,16,12,0,8,18,1,1,2,1,0,1,1,1
22200246,False,DEN,14400,98,30,15,15,12,0,7,14,2,4,6,0,3,3,3,3
22200247,True,LAL,14400,123,70,48,22,17,1,5,12,4,1,5,1,6,6,6,7
22200247,False,SAS,14400,92,57,34,23,21,2,10,21,1,0,1,1,3,4,2,4
22200248,True,CLE,14400,114,57,37,20,20,0,10,22,3,2,5,0,6,6,1,6
22200248,False,ATL,14400,102,41,32,9,17,0,7,15,3,4,7,0,6,4,2,6
22200249,True,IND,14400,123,53,32,21,12,1,6,13,5,5,10,1,7,8,4,8
22200249,False,ORL,14400,102,44,17,27,19,2,9,20,0,3,3,1,10,11,5,11
22200250,True,CHI,14400,121,52,17,35,20,0,14,36,0,3,3,3,7,10,4,10
22200250,False,BOS,14400,107,56,39,17,13,1,11,28,1,1,2,1,12,13,3,13
22200251,True,MIL,14400,119,54,46,8,18,0,8,18,3,5,8,0,8,5,3,8
22200251,False,POR,14400,111,39,26,13,10,0,18,40,2,1,3,0,5,4,1,5
22200252,True,MIN,14400,105,57,32,25,15,0,6,14,2,4,6,0,0,0,0,0
22200252,False,MIA,14400,101,43,20,23,19,2,9,23,2,2,4,1,5,6,3,6
22200253,True,NOP,14400,128,37,17,20,17,0,6,14,0,6,6,3,4,7,6,7
22200253,False,GSW,14400,83,48,26,22,15,0,6,16,0,3,3,1,7,8,7,8
22200254,True,OKC,14400,119,54,32,22,16,2,7,15,2,2,4,2,9,8,2,11
22200254,False,NYK,14400,129,44,34,10,11,1,9,21,2,5,7,1,8,6,2,9
22200255,True,LAC,14400,121,58,29,29,9,1,15,32,2,3,5,2,8,10,4,10
22200255,False,UTA,14400,114,64,49,15,23,0,9,22,3,1,4,2,2,4,1,4
22200256,True,PHI,14400,115,41,28,13,16,0,13,32,5,1,6,1,9,8,5,10
22200256,False,BKN,14400,106,56,41,15,12,0,7,16,0,3,3,0,3,3,1,3
22200257,True,MEM,14400,109,48,31,17,24,0,6,12,3,0,3,1,3,3,2,4
22200257,False,SAC,14400,113,49,34,15,10,1,10,24,4,4,8,1,11,10,6,12
22200258,True,DEN,14400,108,43,31,12,20,2,8,17,6,3,9,3,1,4,4,4
22200258,False,DET,14400,110,50,34,16,15,0,9,20,4,3,7,0,3,3,2,3
22200259,True,PHX,14400,115,38,30,8,19,0,17,35,3,1,4,1,6,7,2,7
22200259,False,LAL,14400,105,60,40,20,16,0,4,8,4,3,7,0,10,10,7,10
22200260,True,CHA,14400,107,52,30,22,22,0,6,12,4,3,7,1,5,6,4,6
22200260,False,PHI,14400,101,54,39,15,16,0,16,36,4,5,9,0,5,5,2,5
22200261,True,CLE,14400,114,52,30,22,13,2,10,23,0,2,2,1,10,8,3,11
22200261,False,POR,14400,96,41,27,14,17,1,6,16,4,4,8,5,2,6,6,7
22200262,True,IND,14400,101,40,26,14,27,0,12,27,6,5,11,3,4,7,3,7
22200262,False,MIN,14400,115,56,33,23,18,0,8,18,0,5,5,0,12,9,5,12
22200263,True,ATL,14400,115,48,31,17,13,0,14,31,3,1,4,1,2,3,2,3
22200263,False,SAC,14400,106,50,28,22,14,1,9,22,3,3,6,1,4,4,2,5
22200264,True,BOS,14400,125,42,22,20,7,1,13,33,0,1,1,0,5,5,1,5
22200264,False,DAL,14400,112,40,28,12,8,0,6,13,2,2,4,0,1,1,1,1
22200265,True,MIA,14400,113,48,25,23,9,1,8,19,3,1,4,0,10,9,5,10
22200265,False,WAS,14400,105,57,31,26,10,0,7,16,4,2,6,1,1,2,1,2
22200266,True,TOR,14400,98,46,18,28,24,1,8,20,2,2,4,1,3,3,1,4
22200266,False,BKN,14400,112,65,43,22,22,1,3,6,0,2,2,0,4,4,2,4
22200267,True,MIL,14400,113,40,26,14,12,0,8,18,3,1,4,3,3,5,2,6
22200267,False,CHI,14400,118,48,30,18,11,2,14,32,0,6,6,1,9,9,4,10
22200268,True,OKC,15900,126,44,27,17,19,2,9,19,1,4,5,1,7,5,1,8
22200268,False,DEN,15900,131,54,35,19,14,0,4,10,6,1,7,2,0,2,2,2
22200269,True,SAS,14400,110,43,32,11,15,0,12,27,5,4,9,0,4,3,3,4
22200269,False,NOP,14400,129,57,32,25,15,2,8,16,6,6,12,2,10,11,7,12
22200270,True,UTA,14400,116,46,40,6,14,0,11,30,1,2,3,1,3,4,1,4
22200270,False,DET,14400,125,43,24,19,10,0,11,25,3,4,7,1,4,5,4,5
22200271,True,GSW,14400,124,54,41,13,14,1,5,12,0,2,2,0,7,7,4,7
22200271,False,LAC,14400,107,38,21,17,10,0,5,10,0,4,4,3,4,7,6,7
22200272,True,CHA,14400,110,63,38,25,17,0,15,33,6,3,9,0,3,3,1,3
22200272,False,MIN,14400,108,55,41,14,21,0,9,20,3,2,5,0,4,3,2,4
22200273,True,ORL,14400,99,46,23,23,16,0,7,15,6,3,9,5,4,8,7,9
22200273,False,PHI,14400,107,44,19,25,21,2,13,30,5,3,8,2,12,13,8,14
22200274,True,NYK,15900,129,48,31,17,16,1,6,15,4,1,5,3,12,15,6,15
22200274,False,POR,15900,132,52,31,21,13,1,11,25,4,0,4,1,5,6,2,6
22200275,True,BOS,14400,122,59,41,18,17,0,9,25,4,5,9,1,16,15,3,17
22200275,False,SAC,14400,104,48,25,23,9,1,13,33,5,0,5,2,4,6,1,6
22200276,True,IND,14400,128,44,26,18,14,0,13,30,4,3,7,1,1,2,2,2
22200276,False,BKN,14400,117,49,32,17,10,0,5,13,0,1,1,0,9,9,4,9
22200277,True,MIA,14400,110,46,19,27,10,1,5,11,0,3,3,1,5,6,0,6
22200277,False,WAS,14400,107,45,29,16,11,1,6,12,4,2,6,1,1,2,1,2
22200278,True,HOU,14400,128,48,19,29,17,0,13,31,3,3,6,3,5,7,3,8
22200278,False,ATL,14400,122,51,21,30,20,0,15,37,2,3,5,1,3,2,2,4
22200279,True,MEM,14400,132,45,33,12,7,0,9,22,5,2,7,2,7,5,3,9
22200279,False,NOP,14400,111,49,25,24,17,0,2,5,4,3,7,0,10,5,2,10
22200280,True,MIL,14400,117,48,31,17,11,0,12,26,2,3,5,0,4,3,1,4
22200280,False,CLE,14400,102,38,27,11,12,0,9,23,5,3,8,2,7,4,2,9
22200281,True,OKC,15900,123,59,44,15,12,0,5,12,2,4,6,1,2,3,2,3
22200281,False,CHI,15900,119,54,39,15,13,0,9,21,3,3,6,4,2,5,5,6
22200282,True,SAS,14400,94,49,29,20,26,2,8,17,2,3,5,2,2,4,3,4
22200282,False,LAL,14400,105,55,35,20,15,0,4,10,5,5,10,0,3,3,3,3
22200283,True,PHX,14400,108,54,39,15,8,0,9,20,2,1,3,0,11,11,3,11
22200283,False,DET,14400,102,42,28,14,11,0,11,23,1,1,2,2,6,8,2,8
22200284,True,GSW,14400,129,43,29,14,13,1,16,40,2,4,6,1,1,2,1,2
22200284,False,UTA,14400,118,31,23,8,20,0,7,15,3,2,5,1,0,1,1,1
22200285,True,LAC,14400,104,54,37,17,10,0,6,14,0,0,0,1,8,8,2,9
22200285,False,DEN,14400,114,52,36,16,19,0,7,15,3,1,4,3,10,13,5,13
22200286,True,TOR,14400,105,37,18,19,21,2,9,22,2,3,5,2,7,9,5,9
22200286,False,DAL,14400,100,57,37,20,13,0,3,7,3,2,5,1,12,13,4,13
22200287,True,HOU,14400,118,43,18,25,17,1,11,27,4,2,6,1,3,4,3,4
22200287,False,OKC,14400,105,47,23,24,12,0,10,26,1,1,2,0,3,3,0,3
22200288,True,SAS,14400,138,38,25,13,13,2,3,6,2,2,4,0,4,4,0,4
22200288,False,LAL,14400,143,55,38,17,6,1,15,35,0,3,3,0,6,5,1,6
22200289,True,PHX,14400,113,36,25,11,11,0,10,21,3,1,4,0,10,10,4,10
22200289,False,UTA,14400,112,44,39,5,11,0,9,22,0,2,2,0,8,8,3,8
22200290,True,BKN,14400,111,28,16,12,15,0,11,26,4,3,7,1,6,7,2,7
22200290,False,POR,14400,97,23,13,10,9,0,7,17,3,1,4,1,1,2,1,2
22200291,True,MIN,14400,114,28,13,15,13,0,14,35,0,1,1,1,1,2,1,2
22200291,False,GSW,14400,137,50,25,25,11,0,18,45,3,3,6,0,4,4,2,4
22200292,True,LAC,14400,114,23,21,2,10,0,8,16,1,4,5,1,2,2,1,3
22200292,False,IND,14400,100,31,20,11,13,0,3,6,4,2,6,2,6,7,3,8
22200293,True,ATL,14400,98,33,21,12,10,0,1,2,1,0,1,2,0,2,2,2
22200293,False,MIA,14400,106,44,28,16,15,0,6,12,0,0,0,0,3,3,1,3
22200294,True,BOS,14400,130,50,35,15,5,0,10,25,3,0,3,1,4,5,1,5
22200294,False,WAS,14400,121,42,22,20,16,0,11,23,0,4,4,0,5,4,1,5
22200295,True,DET,14400,94,44,25,19,15,0,10,20,3,2,5,0,1,1,1,1
22200295,False,CLE,14400,102,50,30,20,6,0,8,17,1,1,2,0,4,3,3,4
22200296,True,NYK,14400,123,52,35,17,13,0,6,13,2,2,4,2,7,8,5,9
22200296,False,MEM,14400,127,47,35,12,6,1,13,32,2,0,2,3,8,11,4,11
22200297,True,ORL,14400,103,40,22,18,13,2,8,16,2,4,6,2,3,4,2,5
22200297,False,PHI,14400,133,42,22,20,15,1,8,21,4,3,7,0,8,7,6,8
22200298,True,MIL,14400,124,43,22,21,15,0,8,18,1,2,3,0,4,4,2,4
22200298,False,DAL,14400,115,49,29,20,8,1,9,20,2,1,3,0,8,7,5,8
22200299,True,PHI,14400,104,40,25,15,19,0,6,15,7,5,12,0,2,1,1,2
22200299,False,ATL,14400,101,46,28,18,12,1,10,21,3,4,7,0,0,0,0,0
22200300,True,WAS,14400,142,36,23,13,22,0,13,29,4,5,9,1,7,7,2,8
22200300,False,MIN,14400,127,42,26,16,15,0,14,32,2,1,3,4,6,10,2,10
22200301,True,BOS,14400,140,56,36,20,13,1,15,38,5,8,13,2,9,11,4,11
22200301,False,CHA,14400,105,48,18,30,17,0,8,17,2,6,8,2,8,8,5,10
22200302,True,BKN,14400,109,42,24,18,10,0,8,19,2,0,2,0,4,4,2,4
22200302,False,ORL,14400,102,51,30,21,12,0,6,15,2,2,4,1,4,5,1,5
22200303,True,TOR,14400,100,55,36,19,15,0,6,15,5,4,9,0,2,2,1,2
22200303,False,CLE,14400,88,59,39,20,12,0,6,15,4,1,5,0,13,12,2,13
22200304,True,NOP,14400,105,40,24,16,23,2,5,10,2,5,7,2,4,6,4,6
22200304,False,OKC,14400,101,33,20,13,24,1,7,15,4,6,10,1,4,5,1,5
22200305,True,DEN,14400,129,37,19,18,13,0,14,31,1,1,2,0,3,3,1,3
22200305,False,HOU,14400,113,25,16,9,8,0,7,17,4,1,5,2,0,2,2,2
22200306,True,UTA,14400,107,47,38,9,11,0,5,13,3,3,6,0,3,2,2,3
22200306,False,CHI,14400,114,60,23,37,16,1,7,15,1,1,2,0,4,4,2,4
22200307,True,SAC,14400,117,46,31,15,8,1,12,26,1,3,4,0,4,4,0,4
22200307,False,PHX,14400,122,40,32,8,11,0,10,21,0,5,5,0,7,7,1,7
22200308,True,LAL,14400,115,51,29,22,4,0,4,9,4,6,10,2,5,7,2,7
22200308,False,IND,14400,116,43,29,14,15,0,18,40,2,6,8,0,7,5,1,7
22200309,True,DET,14400,110,53,34,19,10,0,11,24,2,3,5,3,2,5,4,5
22200309,False,NYK,14400,140,44,23,21,13,0,9,23,4,8,12,2,11,11,9,13
22200310,True,DAL,14400,116,41,20,21,19,0,10,22,4,0,4,1,5,6,3,6
22200310,False,GSW,14400,113,49,27,22,20,1,6,14,0,4,4,3,10,13,10,13
22200311,True,POR,14400,112,61,42,19,10,1,12,32,2,2,4,1,6,7,4,7
22200311,False,LAC,14400,118,61,39,22,11,1,6,12,4,1,5,3,6,9,8,9
22200312,True,CLE,14400,113,55,37,18,13,0,11,26,0,6,6,1,3,4,1,4
22200312,False,PHI,14400,85,38,21,17,22,0,8,17,0,1,1,2,2,4,4,4
22200313,True,ORL,14400,108,51,28,23,17,0,10,21,1,5,6,1,9,8,3,10
22200313,False,ATL,14400,125,44,25,19,14,1,13,28,1,1,2,6,9,15,12,15
22200314,True,BOS,14400,134,41,23,18,9,2,1,3,5,6,11,0,2,2,1,2
22200314,False,MIA,14400,121,40,14,26,12,1,16,39,2,3,5,0,3,2,0,3
22200315,True,BKN,14400,113,54,38,16,18,0,11,24,0,5,5,0,12,10,3,12
22200315,False,WAS,14400,107,48,34,14,12,0,8,17,2,6,8,2,8,10,5,10
22200316,True,NYK,14400,103,42,24,18,7,0,10,21,6,3,9,5,9,13,9,14
22200316,False,MIL,14400,109,60,42,18,6,1,7,16,4,2,6,4,2,6,6,6
22200317,True,MIN,14400,109,42,26,16,13,0,12,27,1,3,4,0,6,6,2,6
22200317,False,MEM,14400,101,41,20,21,12,0,7,16,3,0,3,3,9,10,5,12
22200318,True,NOP,14400,126,43,24,19,15,1,6,15,4,3,7,0,10,10,6,10
22200318,False,TOR,14400,108,35,24,11,17,0,7,20,1,2,3,0,1,1,1,1
22200319,True,OKC,14400,119,60,35,25,12,0,11,24,0,0,0,0,4,3,2,4
22200319,False,SAS,14400,111,53,35,18,14,0,5,10,0,2,2,0,1,0,0,1
22200320,True,DEN,14400,120,48,25,23,21,0,5,12,4,5,9,0,3,3,1,3
22200320,False,HOU,14400,100,40,26,14,12,0,7,15,1,1,2,1,5,6,3,6
22200321,True,PHX,14400,132,41,27,14,8,0,17,38,1,1,2,2,7,8,7,9
22200321,False,CHI,14400,113,47,32,15,10,0,6,13,0,3,3,1,3,4,3,4
22200322,True,UTA,14400,125,53,39,14,14,0,12,30,4,4,8,1,11,9,3,12
22200322,False,LAC,14400,112,38,22,16,17,0,9,18,6,6,12,4,4,6,2,8
22200323,True,SAC,14400,137,42,24,18,12,2,8,21,2,3,5,0,2,2,1,2
22200323,False,IND,14400,114,33,22,11,12,1,1,2,2,2,4,2,3,5,5,5
22200324,True,LAL,14400,128,40,31,9,12,1,5,11,2,1,3,3,1,4,4,4
22200324,False,POR,14400,109,37,23,14,14,0,12,25,0,3,3,0,5,4,1,5
22200325,True,DET,15900,131,49,17,32,14,0,15,36,1,2,3,1,2,3,2,3
22200325,False,DAL,15900,125,62,36,26,14,0,9,24,1,2,3,1,2,3,2,3
22200326,True,CHA,14400,117,43,27,16,6,0,8,18,4,4,8,1,7,4,1,8
22200326,False,WAS,14400,116,61,42,19,7,0,8,17,4,4,8,3,5,7,4,8
22200327,True,ATL,14400,117,48,27,21,28,1,13,28,1,1,2,3,7,10,4,10
22200327,False,DEN,14400,109,47,28,19,16,0,10,23,3,2,5,2,8,10,8,10
22200328,True,BOS,15900,116,48,30,18,8,1,3,7,2,2,4,1,2,3,3,3
22200328,False,MIA,15900,120,35,17,18,16,2,12,30,1,0,1,2,5,7,3,7
22200329,True,BKN,14400,114,53,34,19,9,0,8,16,6,3,9,0,10,9,6,10
22200329,False,TOR,14400,105,44,24,20,13,1,8,16,0,2,2,0,1,0,0,1
22200330,True,CLE,14400,107,54,42,12,12,2,6,14,1,4,5,1,3,4,0,4
22200330,False,ORL,14400,96,45,27,18,11,1,14,30,3,2,5,2,3,4,1,5
22200331,True,MIL,14400,129,61,45,16,8,0,15,35,3,1,4,1,2,3,1,3
22200331,False,LAL,14400,133,45,26,19,10,2,15,34,1,1,2,0,5,5,0,5
22200332,True,MEM,14400,117,53,42,11,12,0,6,12,3,2,5,4,4,7,6,8
22200332,False,PHI,14400,109,41,30,11,12,1,6,16,4,4,8,2,5,7,6,7
22200333,True,SAS,14400,99,31,17,14,7,1,5,12,2,4,6,1,5,5,4,6
22200333,False,NOP,14400,117,30,20,10,16,0,6,15,3,1,4,2,5,6,5,7
22200334,True,PHX,14400,121,28,23,5,10,1,11,25,3,5,8,4,3,7,5,7
22200334,False,HOU,14400,122,32,21,11,20,0,4,8,4,4,8,0,4,4,4,4
22200335,True,UTA,14400,139,51,38,13,13,1,6,14,0,3,3,2,7,9,9,9
22200335,False,IND,14400,119,52,27,25,19,1,8,19,2,2,4,1,4,4,1,5
22200336,True,GSW,14400,119,60,43,17,16,2,17,42,2,0,2,2,1,3,1,3
22200336,False,CHI,14400,111,41,15,26,22,0,9,22,0,3,3,2,4,6,5,6
22200337,True,NYK,14400,100,64,22,42,13,1,5,12,4,3,7,0,8,7,3,8
22200337,False,DAL,14400,121,49,25,24,16,1,8,19,3,5,8,2,6,7,5,8
22200338,True,LAC,14400,96,49,31,18,17,0,4,9,3,0,3,4,4,8,7,8
22200338,False,SAC,14400,123,50,32,18,14,1,9,20,0,3,3,2,4,5,2,6
22200339,True,CHA,14400,96,51,27,24,18,0,12,25,0,0,0,1,4,5,3,5
22200339,False,MIL,14400,105,56,37,19,9,0,10,23,3,3,6,0,3,3,2,3
22200340,True,TOR,14400,121,47,31,16,24,0,4,8,1,3,4,0,3,3,3,3
22200340,False,ORL,14400,108,38,22,16,19,0,11,23,0,1,1,0,4,4,3,4
22200341,True,MIN,14400,128,32,27,5,22,0,7,15,0,0,0,3,0,3,2,3
22200341,False,OKC,14400,135,38,19,19,12,3,7,15,2,1,3,1,0,1,1,1
22200342,True,GSW,14400,120,62,39,23,24,0,11,31,1,2,3,0,9,9,5,9
22200342,False,HOU,14400,101,62,20,42,15,1,5,12,1,2,3,0,1,1,1,1
22200343,True,UTA,14400,111,37,27,10,13,0,2,5,4,1,5,0,2,2,1,2
22200343,False,POR,14400,116,38,22,16,10,0,10,25,2,3,5,3,5,8,4,8
22200344,True,NOP,14400,121,40,30,10,13,1,9,19,4,5,9,0,5,4,1,5
22200344,False,DEN,14400,106,29,22,7,9,0,7,16,2,1,3,2,5,7,6,7
22200345,True,SAS,14400,95,58,34,24,22,0,5,10,0,1,1,0,3,3,1,3
22200345,False,PHX,14400,133,57,32,25,11,1,6,13,1,3,4,1,5,6,4,6
22200346,True,BKN,14400,92,48,26,22,10,0,2,5,3,1,4,0,2,2,1,2
22200346,False,BOS,14400,103,44,30,14,13,0,3,7,3,2,5,1,4,5,1,5
22200347,True,DET,14400,112,55,30,25,20,0,8,17,0,0,0,0,2,2,1,2
22200347,False,MEM,14400,122,34,23,11,17,0,11,28,2,2,4,2,2,4,2,4
22200348,True,NYK,14400,92,35,22,13,13,0,3,7,2,2,4,0,5,5,3,5
22200348,False,CLE,14400,81,38,23,15,17,1,4,9,2,3,5,0,7,7,4,7
22200349,True,WAS,14400,119,44,34,10,15,0,10,22,0,1,1,0,3,3,0,3
22200349,False,LAL,14400,130,42,29,13,9,2,3,6,3,0,3,2,2,4,3,4
22200350,True,SAC,14400,110,45,33,12,11,1,10,23,4,3,7,1,4,4,3,5
22200350,False,CHI,14400,101,39,22,17,19,0,4,8,3,2,5,1,6,6,2,7
22200351,True,POR,14400,116,43,27,16,13,1,10,23,1,2,3,2,2,4,3,4
22200351,False,IND,14400,100,46,24,22,24,0,7,15,3,4,7,1,4,5,1,5
22200352,True,CHA,14400,117,64,41,23,11,0,11,25,3,0,3,0,7,7,3,7
22200352,False,LAC,14400,119,64,43,21,15,0,11,24,2,2,4,2,9,11,5,11
22200353,True,ORL,14400,102,45,21,24,19,1,12,26,2,3,5,4,9,11,6,13
22200353,False,MIL,14400,109,45,29,16,12,0,3,6,3,4,7,3,4,7,4,7
22200354,True,ATL,14400,114,55,34,21,16,2,11,24,3,2,5,2,4,6,4,6
22200354,False,OKC,14400,121,60,38,22,14,1,8,17,3,7,10,1,9,10,5,10
22200355,True,TOR,14400,110,46,28,18,12,0,6,13,5,1,6,1,4,5,5,5
22200355,False,BOS,14400,116,39,25,14,14,3,6,15,4,2,6,2,14,15,7,16
22200356,True,HOU,17400,132,36,23,13,14,0,6,14,3,1,4,2,2,4,4,4
22200356,False,PHI,17400,123,42,20,22,25,0,3,7,2,3,5,0,3,3,1,3
22200357,True,MEM,14400,101,45,25,20,14,0,7,16,0,2,2,1,1,1,0,2
22200357,False,MIA,14400,93,40,22,18,13,0,3,6,1,5,6,0,9,8,2,9
22200358,True,DAL,14400,130,50,35,15,12,0,15,35,1,1,2,0,8,8,2,8
22200358,False,PHX,14400,111,48,23,25,11,0,5,11,7,0,7,1,8,5,3,9
22200359,True,GSW,14400,104,57,27,30,21,0,7,19,2,0,2,1,5,6,4,6
22200359,False,IND,14400,112,45,18,27,14,3,6,14,3,0,3,1,5,6,6,6
22200360,True,CLE,14400,116,52,31,21,16,0,16,35,1,5,6,1,6,5,2,7
22200360,False,LAL,14400,102,48,32,16,6,0,6,12,5,3,8,2,2,4,4,4
22200361,True,MIA,14400,96,36,20,16,19,0,5,10,1,1,2,1,7,8,3,8
22200361,False,DET,14400,116,41,23,18,10,1,4,10,3,4,7,2,1,3,3,3
22200362,True,DEN,14400,115,38,19,19,18,0,9,22,2,2,4,0,5,1,1,5
22200362,False,DAL,14400,116,42,24,18,14,1,3,9,2,4,6,0,6,5,1,6
22200363,True,ORL,15900,116,52,32,20,13,0,9,18,3,5,8,2,7,5,3,9
22200363,False,LAC,15900,111,66,54,12,13,0,3,6,6,4,10,4,3,6,4,7
22200364,True,BKN,14400,122,44,34,10,18,0,14,30,1,4,5,0,6,4,2,6
22200364,False,CHA,14400,116,48,33,15,18,0,14,31,1,1,2,1,2,3,2,3
22200365,True,NYK,14400,113,50,26,24,14,0,6,17,2,3,5,5,20,24,11,25
22200365,False,ATL,14400,89,49,30,19,17,1,11,22,5,4,9,1,6,7,3,7
22200366,True,TOR,14400,126,57,35,22,17,0,9,20,2,3,5,0,9,6,4,9
22200366,False,LAL,14400,113,68,42,26,14,1,5,10,3,2,5,1,13,12,1,14
22200367,True,CHI,14400,115,42,18,24,15,0,10,23,0,2,2,0,3,3,0,3
22200367,False,WAS,14400,111,42,30,12,10,0,12,25,2,1,3,1,3,2,2,4
22200368,True,MEM,14400,123,33,23,10,18,1,8,21,1,2,3,1,1,2,2,2
22200368,False,OKC,14400,102,33,17,16,15,1,3,8,0,1,1,0,3,3,1,3
22200369,True,MIL,14400,126,27,21,6,10,0,2,4,5,1,6,3,2,5,4,5
22200369,False,SAC,14400,113,31,28,3,8,0,13,29,0,0,0,2,2,4,3,4
22200370,True,MIN,14400,121,23,16,7,13,0,5,12,1,4,5,0,7,7,4,7
22200370,False,IND,14400,115,33,24,9,11,0,8,19,2,2,4,2,7,9,4,9
22200371,True,NOP,14400,104,38,26,12,15,0,4,9,2,2,4,2,7,9,6,9
22200371,False,DET,14400,98,36,24,12,12,1,8,20,3,2,5,3,3,6,3,6
22200372,True,UTA,14400,124,48,27,21,15,1,13,31,2,2,4,1,3,3,2,4
22200372,False,GSW,14400,123,50,28,22,9,0,16,38,2,2,4,1,6,7,2,7
22200373,True,PHX,14400,98,66,40,26,17,0,8,17,2,0,2,1,3,2,2,4
22200373,False,BOS,14400,125,58,40,18,17,0,10,24,3,3,6,3,6,9,3,9
22200374,True,MIA,14400,115,41,22,19,29,1,7,17,1,2,3,3,9,12,7,12
22200374,False,LAC,14400,110,42,28,14,9,0,10,25,7,3,10,0,3,3,1,3
22200375,True,SAS,14400,118,62,46,16,16,0,13,29,2,2,4,0,6,4,2,6
22200375,False,HOU,14400,109,52,28,24,12,0,8,16,1,2,3,0,4,4,2,4
22200376,True,POR,14400,120,53,33,20,17,2,12,33,1,4,5,0,4,3,0,4
22200376,False,DEN,14400,121,45,27,18,14,1,6,16,2,2,4,3,4,5,2,7
22200377,True,CHA,14400,102,43,20,23,12,0,17,37,0,1,1,0,5,5,2,5
22200377,False,NYK,14400,121,35,18,17,11,0,9,21,3,1,4,1,4,4,1,5
22200378,True,IND,14400,121,43,28,15,13,1,10,23,2,4,6,1,4,3,1,5
22200378,False,WAS,14400,111,56,30,26,13,0,5,11,3,3,6,0,6,2,1,6
22200379,True,ORL,14400,113,47,30,17,4,1,4,8,0,4,4,1,6,7,5,7
22200379,False,TOR,14400,109,33,22,11,28,1,8,19,0,5,5,0,3,3,1,3
22200380,True,BKN,14400,120,32,22,10,14,0,10,23,2,3,5,2,4,6,3,6
22200380,False,ATL,14400,116,33,22,11,14,0,9,21,2,3,5,2,0,2,2,2
22200381,True,CLE,14400,95,40,20,20,18,0,11,24,2,2,4,1,4,5,1,5
22200381,False,SAC,14400,106,41,24,17,15,1,6,16,1,1,2,1,2,3,2,3
22200382,True,PHI,15900,133,31,18,13,22,0,9,20,1,2,3,2,3,4,2,5
22200382,False,LAL,15900,122,27,15,12,23,4,3,6,1,5,6,2,1,2,2,3
22200383,True,MEM,14400,114,40,28,12,11,0,7,16,0,3,3,1,6,7,4,7
22200383,False,DET,14400,103,44,32,12,8,0,11,25,1,3,4,3,4,7,5,7
22200384,True,NOP,14400,128,41,21,20,19,1,8,17,0,2,2,3,5,8,6,8
22200384,False,PHX,14400,117,41,29,12,16,0,7,17,3,4,7,0,4,4,2,4
22200385,True,UTA,14400,108,23,14,9,13,1,10,25,0,3,3,1,3,2,1,4
22200385,False,MIN,14400,118,38,24,14,20,0,10,22,3,4,7,0,3,3,2,3
22200386,True,DAL,14400,105,47,30,17,15,1,8,18,2,4,6,2,4,6,4,6
22200386,False,MIL,14400,106,36,20,16,10,0,6,15,1,0,1,1,2,3,2,3
22200387,True,MIA,14400,111,43,30,13,11,1,10,23,3,2,5,0,7,5,3,7
22200387,False,SAS,14400,115,52,30,22,17,0,7,14,4,5,9,1,3,4,4,4
22200388,True,IND,14400,133,48,36,12,18,1,5,12,2,2,4,0,0,0,0,0
22200388,False,BKN,14400,136,40,24,16,11,0,7,15,1,2,3,3,6,9,4,9
22200389,True,WAS,14400,107,55,26,29,12,0,7,19,2,1,3,1,7,8,1,8
22200389,False,LAC,14400,114,44,29,15,18,0,6,14,0,1,1,0,4,3,1,4
22200390,True,CLE,14400,110,46,29,17,15,0,4,9,3,1,4,1,2,3,2,3
22200390,False,OKC,14400,102,49,29,20,17,0,1,2,2,3,5,0,4,3,1,4
22200391,True,CHI,14400,144,34,22,12,10,0,6,12,1,1,2,1,1,2,1,2
22200391,False,DAL,14400,115,24,21,3,5,0,8,16,1,0,1,1,0,1,0,1
22200392,True,GSW,14400,123,52,26,26,13,0,19,46,0,0,0,0,0,0,0,0
22200392,False,BOS,14400,107,38,17,21,18,0,15,36,2,1,3,0,2,2,0,2
22200393,True,DEN,14400,115,38,22,16,9,0,10,20,0,1,1,0,6,6,3,6
22200393,False,UTA,14400,110,35,25,10,17,0,0,0,4,2,6,2,8,10,4,10
22200394,True,POR,14400,124,36,28,8,4,0,16,37,2,1,3,0,5,4,4,5
22200394,False,MIN,14400,118,27,21,6,17,0,7,18,1,3,4,0,0,0,0,0
22200395,True,NOP,15900,129,30,19,11,23,0,6,12,2,3,5,0,12,12,6,12
22200395,False,PHX,15900,124,26,19,7,16,2,7,16,7,1,8,4,4,8,4,8
22200396,True,DET,14400,117,36,25,11,16,0,11,25,3,2,5,1,3,2,1,4
22200396,False,LAL,14400,124,37,15,22,13,0,3,6,3,0,3,0,8,8,8,8
22200397,True,NYK,14400,112,25,17,8,13,1,7,15,3,3,6,4,3,7,6,7
22200397,False,SAC,14400,99,23,17,6,11,0,4,10,2,2,4,1,2,3,2,3
22200398,True,ORL,14400,111,30,27,3,7,1,3,6,5,2,7,1,5,6,4,6
22200398,False,TOR,14400,99,32,22,10,14,1,5,10,1,1,2,2,2,4,4,4
22200399,True,PHI,14400,131,43,28,15,13,1,4,8,0,1,1,1,5,6,2,6
22200399,False,CHA,14400,113,33,27,6,22,0,12,30,3,4,7,2,2,3,1,4
22200400,True,ATL,15900,123,57,43,14,18,2,6,13,1,2,3,0,5,5,3,5
22200400,False,CHI,15900,122,60,33,27,15,0,5,11,3,4,7,1,2,2,2,3
22200401,True,HOU,14400,97,48,23,25,18,0,16,36,4,6,10,0,3,2,0,3
22200401,False,MIL,14400,92,52,40,12,13,0,9,21,1,0,1,0,7,6,4,7
22200402,True,IND,14400,82,41,28,13,19,1,5,10,2,3,5,2,4,6,1,6
22200402,False,MIA,14400,87,35,16,19,16,1,6,15,0,2,2,2,7,7,3,9
22200403,True,WAS,14400,100,34,24,10,12,0,6,12,5,2,7,1,1,2,2,2
22200403,False,BKN,14400,112,39,28,11,9,1,7,15,1,2,3,1,3,4,1,4
22200404,True,MEM,14400,128,76,54,22,23,0,7,18,2,2,4,1,10,9,4,11
22200404,False,ATL,14400,103,44,23,21,20,0,10,21,5,2,7,4,6,9,4,10
22200405,True,DAL,14400,121,23,18,5,7,1,7,17,0,2,2,0,2,2,2,2
22200405,False,OKC,14400,114,27,17,10,10,1,5,10,2,2,4,0,7,7,0,7
22200406,True,SAS,14400,112,39,31,8,16,0,11,22,4,3,7,2,1,3,3,3
22200406,False,CLE,14400,111,66,45,21,13,0,14,29,4,2,6,2,5,6,3,7
22200407,True,POR,14400,133,54,33,21,15,1,11,28,1,2,3,1,5,6,3,6
22200407,False,MIN,14400,112,50,24,26,21,0,6,13,1,4,5,0,4,4,3,4
22200408,True,LAC,14400,113,34,15,19,22,0,15,32,1,1,2,0,4,4,0,4
22200408,False,BOS,14400,93,52,41,11,14,1,14,32,1,2,3,0,2,2,0,2
22200409,True,PHI,14400,123,47,26,21,18,1,6,16,3,2,5,0,10,10,5,10
22200409,False,SAC,14400,103,54,33,21,9,3,10,23,5,2,7,1,4,5,3,5
22200410,True,MIL,14400,128,40,25,15,11,0,11,25,5,3,8,1,3,4,2,4
22200410,False,GSW,14400,111,47,29,18,19,2,16,43,3,2,5,2,5,6,3,7
22200411,True,HOU,14400,111,61,28,33,14,1,7,17,4,3,7,0,6,6,5,6
22200411,False,PHX,14400,97,56,30,26,32,0,10,26,3,3,6,0,2,2,2,2
22200412,True,UTA,14400,121,36,29,7,10,1,12,29,2,3,5,4,4,8,5,8
22200412,False,NOP,14400,100,44,22,22,21,0,7,14,2,3,5,2,8,8,4,10
22200413,True,LAL,15900,118,51,31,20,14,0,6,15,0,4,4,1,4,5,3,5
22200413,False,BOS,15900,122,31,21,10,10,0,12,30,1,2,3,0,8,8,1,8
22200414,True,CHA,15900,134,48,32,16,13,0,11,23,3,3,6,2,5,7,3,7
22200414,False,DET,15900,141,80,40,40,3,0,17,39,1,1,2,1,3,4,3,4
22200415,True,IND,14400,125,50,30,20,19,0,12,31,3,5,8,1,5,4,3,6
22200415,False,GSW,14400,119,53,26,27,18,1,10,23,2,2,4,1,11,9,1,12
22200416,True,ORL,14400,135,31,15,16,12,1,11,23,2,4,6,0,3,2,1,3
22200416,False,ATL,14400,124,47,29,18,15,1,9,21,0,1,1,1,2,2,1,3
22200417,True,TOR,14400,123,46,23,23,21,0,11,25,3,4,7,1,6,7,3,7
22200417,False,SAC,14400,124,54,39,15,11,0,5,13,4,0,4,1,12,12,7,13
22200418,True,CHI,15900,120,57,38,19,12,3,18,37,2,1,3,0,3,3,2,3
22200418,False,NYK,15900,128,54,36,18,12,0,7,14,1,0,1,2,1,3,3,3
22200419,True,OKC,14400,108,51,19,32,10,0,2,5,1,2,3,0,3,3,1,3
22200419,False,MIA,14400,110,44,27,17,18,1,9,25,0,2,2,0,4,4,1,4
22200420,True,SAS,14400,112,36,18,18,22,1,11,24,1,2,3,1,0,1,1,1
22200420,False,POR,14400,128,47,35,12,9,0,12,31,2,2,4,2,2,4,3,4
22200421,True,DAL,14400,90,45,28,17,14,0,4,10,1,1,2,0,1,1,1,1
22200421,False,CLE,14400,105,40,18,22,12,0,10,24,2,2,4,0,1,1,1,1
22200422,True,DEN,14400,141,31,22,9,11,0,9,19,0,2,2,0,2,2,1,2
22200422,False,WAS,14400,128,29,25,4,12,0,7,17,0,3,3,0,1,1,0,1
22200423,True,LAC,14400,99,47,33,14,20,0,6,13,3,3,6,0,8,8,2,8
22200423,False,MIN,14400,88,53,28,25,19,0,4,9,1,1,2,0,6,6,2,6
22200424,True,HOU,14400,108,48,21,27,15,0,8,16,6,4,10,2,4,6,3,6
22200424,False,MIA,14400,111,49,36,13,17,1,12,30,4,3,7,1,5,6,4,6
22200425,True,MEM,14400,142,54,29,25,10,1,12,27,2,1,3,0,7,3,2,7
22200425,False,MIL,14400,101,51,33,18,13,0,9,20,3,3,6,0,4,3,0,4
22200426,True,UTA,15900,132,38,30,8,16,0,11,28,8,2,10,3,4,7,1,7
22200426,False,NOP,15900,129,46,18,28,16,0,13,26,0,3,3,1,12,12,2,13
22200427,True,LAC,14400,95,45,29,16,17,0,7,16,4,1,5,1,3,3,2,4
22200427,False,PHX,14400,111,47,33,14,16,0,15,31,1,1,2,0,6,6,4,6
22200428,True,CHA,14400,106,52,32,20,17,0,9,22,1,0,1,1,1,1,1,2
22200428,False,ATL,14400,125,56,34,22,10,0,17,41,2,3,5,1,12,10,8,13
22200429,True,DET,14400,113,36,24,12,13,0,8,18,4,1,5,1,2,3,3,3
22200429,False,SAC,14400,122,47,31,16,15,2,10,24,3,3,6,1,4,4,2,5
22200430,True,BOS,14400,109,55,36,19,21,1,6,15,5,3,8,1,2,2,1,3
22200430,False,ORL,14400,117,47,20,27,12,0,7,15,2,2,4,1,3,3,1,4
22200431,True,CLE,14400,118,41,18,23,11,0,6,15,1,2,3,1,3,4,2,4
22200431,False,IND,14400,112,44,20,24,11,0,7,15,2,1,3,0,5,4,1,5
22200432,True,PHI,14400,118,31,17,14,14,0,7,17,2,1,3,0,5,5,3,5
22200432,False,GSW,14400,106,34,21,13,11,0,11,30,1,2,3,1,2,3,1,3
22200433,True,TOR,14400,116,46,35,11,8,1,8,17,2,2,4,0,4,4,2,4
22200433,False,BKN,14400,119,60,44,16,15,0,5,14,2,3,5,1,6,3,1,7
22200434,True,CHI,14400,91,46,27,19,7,1,10,23,2,5,7,0,7,7,7,7
22200434,False,NYK,14400,114,32,25,7,15,2,6,16,4,3,7,5,4,9,7,9
22200435,True,OKC,14400,110,47,37,10,13,0,3,7,5,3,8,0,4,4,2,4
22200435,False,MIN,14400,112,42,25,17,24,1,7,16,2,2,4,1,4,5,1,5
22200436,True,DAL,14400,130,28,21,7,6,0,9,21,0,1,1,0,5,5,1,5
22200436,False,POR,14400,110,19,12,7,6,0,4,10,1,0,1,0,0,0,0,0
22200437,True,LAL,14400,126,23,16,7,17,1,6,12,4,4,8,2,2,3,2,4
22200437,False,DEN,14400,108,23,16,7,16,0,8,17,3,2,5,1,2,3,3,3
22200438,True,LAC,14400,102,54,38,16,21,0,9,18,5,2,7,3,4,7,3,7
22200438,False,WAS,14400,93,53,36,17,19,1,7,16,3,4,7,3,8,11,8,11
22200439,True,SAS,14400,101,43,25,18,12,1,6,14,2,1,3,0,6,6,3,6
22200439,False,MIA,14400,111,45,31,14,21,1,11,25,1,5,6,1,5,6,1,6
22200440,True,CLE,15900,100,42,22,20,8,1,6,13,1,2,3,3,0,3,3,3
22200440,False,DAL,15900,99,35,23,12,10,2,8,19,1,2,3,1,3,3,1,4
22200441,True,HOU,14400,95,21,18,3,9,1,4,8,5,4,9,2,1,3,2,3
22200441,False,POR,14400,107,31,26,5,10,2,12,30,3,1,4,1,4,5,2,5
22200442,True,MIL,14400,123,27,17,10,10,0,9,20,3,2,5,2,4,6,3,6
22200442,False,UTA,14400,97,27,23,4,11,0,18,48,2,2,4,2,1,3,3,3
22200443,True,OKC,14400,115,47,19,28,13,0,3,8,1,3,4,1,13,14,6,14
22200443,False,MEM,14400,109,49,26,23,11,0,10,23,4,1,5,2,12,14,8,14
22200444,True,PHX,14400,118,47,27,20,14,0,12,28,0,1,1,1,3,3,2,4
22200444,False,NOP,14400,114,53,29,24,12,0,6,13,3,1,4,0,13,13,6,13
22200445,True,BOS,14400,92,54,36,18,15,0,6,13,4,3,7,0,5,5,0,5
22200445,False,ORL,14400,95,39,18,21,14,0,10,23,4,4,8,0,5,5,2,5
22200446,True,IND,14400,106,35,23,12,10,1,6,14,4,3,7,1,5,6,4,6
22200446,False,NYK,14400,109,36,25,11,8,1,6,13,4,6,10,3,3,6,6,6
22200447,True,DET,14400,121,47,30,17,7,1,5,11,2,0,2,0,0,0,0,0
22200447,False,BKN,14400,124,52,35,17,9,0,12,29,1,2,3,0,6,4,1,6
22200448,True,TOR,14400,110,37,16,21,16,1,7,19,0,0,0,0,1,1,1,1
22200448,False,GSW,14400,126,55,38,17,13,1,10,26,3,1,4,2,5,6,3,7
22200449,True,MIN,14400,150,35,25,10,12,0,6,12,1,1,2,1,2,2,1,3
22200449,False,CHI,14400,126,33,19,14,8,0,9,18,1,3,4,1,1,2,1,2
22200450,True,DEN,14400,119,42,20,22,11,0,4,9,3,2,5,2,7,9,7,9
22200450,False,CHA,14400,115,40,26,14,19,1,8,18,1,1,2,2,5,7,4,7
22200451,True,LAL,14400,119,45,27,18,5,1,10,22,2,2,4,0,8,8,7,8
22200451,False,WAS,14400,117,42,26,16,10,0,10,23,0,1,1,0,0,0,0,0
22200452,True,CLE,14400,122,47,28,19,10,1,12,31,1,5,6,1,9,10,7,10
22200452,False,UTA,14400,99,35,20,15,18,0,11,27,9,0,9,2,5,7,3,7
22200453,True,PHI,15900,104,46,29,17,14,0,4,10,4,6,10,0,7,5,0,7
22200453,False,TOR,15900,101,50,28,22,16,1,7,16,1,0,1,2,3,4,3,5
22200454,True,ATL,14400,126,72,45,27,15,0,20,45,3,5,8,0,10,5,2,10
22200454,False,ORL,14400,125,63,41,22,14,0,11,22,1,5,6,0,4,4,3,4
22200455,True,HOU,14400,105,34,23,11,14,0,5,11,5,2,7,0,3,1,1,3
22200455,False,SAS,14400,124,47,39,8,10,0,8,18,3,5,8,1,3,4,3,4
22200456,True,MIN,14400,116,39,12,27,12,0,12,28,0,0,0,2,2,2,2,4
22200456,False,DAL,14400,106,42,22,20,10,0,4,12,3,3,6,0,4,4,2,4
22200457,True,NOP,14400,119,37,17,20,15,0,7,15,5,3,8,4,12,14,5,16
22200457,False,MIL,14400,128,48,32,16,14,0,7,18,3,4,7,0,4,3,2,4
22200458,True,OKC,14400,123,39,28,11,12,3,2,4,3,1,4,1,2,3,3,3
22200458,False,POR,14400,121,35,29,6,9,0,5,14,1,2,3,0,5,5,1,5
22200459,True,PHX,14400,130,43,30,13,14,0,18,43,3,3,6,1,10,11,6,11
22200459,False,LAL,14400,104,47,30,17,6,0,13,28,2,2,4,0,4,4,2,4
22200460,True,SAC,14400,119,55,31,24,19,2,6,15,4,2,6,0,5,5,4,5
22200460,False,CHA,14400,125,60,36,24,18,0,8,19,5,1,6,1,2,3,2,3
22200461,True,DET,14400,111,68,31,37,14,1,8,17,3,7,10,0,5,3,2,5
22200461,False,UTA,14400,126,45,34,11,15,1,17,46,4,2,6,2,8,9,4,10
22200462,True,MIA,14400,103,35,14,21,11,0,6,14,1,0,1,0,3,3,1,3
22200462,False,CHI,14400,113,43,14,29,17,0,15,32,2,1,3,0,3,3,1,3
22200463,True,NYK,14400,132,35,15,20,17,1,13,30,3,4,7,6,7,13,11,13
22200463,False,GSW,14400,94,44,24,20,12,0,11,26,2,1,3,1,5,6,3,6
22200464,True,PHX,14400,110,46,26,20,9,0,7,18,3,0,3,0,8,4,1,8
22200464,False,WAS,14400,113,51,33,18,8,0,12,25,1,3,4,0,3,2,2,3
22200465,True,DEN,14400,105,51,32,19,15,2,6,16,2,4,6,0,8,8,3,8
22200465,False,MEM,14400,91,61,46,15,21,0,6,13,3,2,5,3,3,5,2,6
22200466,True,CLE,14400,114,44,29,15,18,0,11,24,3,3,6,1,9,7,2,10
22200466,False,MIL,14400,106,49,29,20,11,0,5,12,5,3,8,4,7,10,5,11
22200467,True,PHI,14400,113,33,25,8,16,0,6,16,0,3,3,1,4,5,4,5
22200467,False,DET,14400,93,32,21,11,7,0,14,30,2,2,4,2,1,3,3,3
22200468,True,ATL,14400,108,58,45,13,11,0,13,31,0,2,2,0,2,2,0,2
22200468,False,CHI,14400,110,51,32,19,16,0,9,18,2,5,7,0,4,4,1,4
22200469,True,BOS,14400,112,67,45,22,28,0,9,21,4,3,7,4,3,7,4,7
22200469,False,IND,14400,117,58,34,24,18,0,6,15,4,6,10,1,5,5,4,6
22200470,True,BKN,14400,143,32,20,12,25,0,20,48,0,3,3,0,3,3,2,3
22200470,False,GSW,14400,113,44,33,11,13,0,8,19,2,0,2,2,0,2,2,2
22200471,True,NYK,14400,106,57,35,22,5,0,4,8,3,0,3,2,5,5,3,7
22200471,False,TOR,14400,113,46,30,16,16,0,11,24,4,4,8,0,6,6,1,6
22200472,True,HOU,14400,110,59,29,30,11,0,6,15,2,2,4,0,5,5,2,5
22200472,False,ORL,14400,116,57,23,34,19,0,7,17,3,3,6,2,4,6,5,6
22200473,True,MIN,14400,99,34,16,18,12,1,10,20,1,0,1,0,4,4,0,4
22200473,False,DAL,14400,104,45,29,16,8,0,7,18,3,1,4,1,12,13,4,13
22200474,True,OKC,14400,101,46,26,20,18,1,11,23,3,1,4,0,1,1,0,1
22200474,False,POR,14400,98,36,26,10,13,0,6,16,1,2,3,2,4,5,2,6
22200475,True,SAC,14400,134,43,26,17,10,3,12,30,0,0,0,1,2,3,2,3
22200475,False,LAL,14400,120,40,22,18,16,1,9,20,0,1,1,0,3,3,3,3
22200476,True,LAC,14400,126,30,25,5,13,0,7,18,0,1,1,2,2,4,3,4
22200476,False,CHA,14400,105,23,11,12,17,0,6,13,4,0,4,0,3,3,0,3
22200477,True,NOP,14400,126,53,37,16,22,2,12,29,4,2,6,1,6,7,4,7
22200477,False,SAS,14400,117,35,23,12,13,0,10,21,6,5,11,0,5,5,3,5
22200478,True,UTA,14400,120,48,32,16,11,0,11,29,4,4,8,0,7,7,5,7
22200478,False,WAS,14400,112,40,25,15,16,0,14,31,2,2,4,0,6,6,1,6
22200479,True,ORL,14400,133,68,39,29,12,1,14,32,3,3,6,0,9,7,4,9
22200479,False,SAS,14400,113,76,52,24,19,0,15,34,2,4,6,1,3,4,3,4
22200480,True,PHI,14400,119,45,28,17,10,0,3,7,2,3,5,0,4,4,1,4
22200480,False,LAC,14400,114,45,28,17,14,0,23,51,1,1,2,2,4,5,4,6
22200481,True,ATL,14400,130,53,32,21,17,1,9,19,1,3,4,1,5,6,4,6
22200481,False,DET,14400,105,43,23,20,8,1,12,26,3,2,5,0,2,2,2,2
22200482,True,BOS,14400,121,71,43,28,15,1,4,10,3,4,7,0,6,6,5,6
22200482,False,MIN,14400,109,66,32,34,13,0,5,10,1,1,2,0,2,2,2,2
22200483,True,BKN,14400,118,34,18,16,20,0,10,24,2,2,4,0,4,3,2,4
22200483,False,MIL,14400,100,43,32,11,11,0,3,6,2,2,4,1,1,1,0,2
22200484,True,CLE,14400,107,51,30,21,14,0,8,18,3,1,4,0,5,4,2,5
22200484,False,TOR,14400,118,40,25,15,23,0,6,16,3,5,8,0,3,2,1,3
22200485,True,NYK,14400,117,47,28,19,4,0,5,12,2,0,2,4,8,12,7,12
22200485,False,CHI,14400,118,57,33,24,16,0,8,16,0,4,4,2,8,10,6,10
22200486,True,MIA,14400,108,36,16,20,8,3,11,27,1,4,5,4,0,2,2,4
22200486,False,IND,14400,111,41,25,16,11,0,9,22,2,1,3,0,0,0,0,0
22200487,True,HOU,14400,106,39,18,21,11,0,7,14,3,1,4,1,1,2,1,2
22200487,False,DAL,14400,112,44,31,13,14,1,13,31,3,2,5,1,2,3,1,3
22200488,True,OKC,15900,125,38,30,8,10,0,2,5,1,3,4,0,4,4,3,4
22200488,False,NOP,15900,128,38,30,8,19,0,4,11,4,1,5,0,4,4,2,4
22200489,True,DEN,14400,120,18,14,4,14,0,7,15,2,1,3,1,4,5,4,5
22200489,False,POR,14400,107,21,16,5,7,1,7,14,2,1,3,1,6,6,2,7
22200490,True,PHX,14400,100,34,29,5,14,0,11,24,2,1,3,0,3,3,2,3
22200490,False,MEM,14400,125,34,22,12,17,0,8,17,1,1,2,4,2,6,6,6
22200491,True,SAC,14400,111,42,22,20,14,1,7,17,3,2,5,1,3,4,3,4
22200491,False,WAS,14400,125,37,24,13,11,1,5,11,0,1,1,1,4,5,4,5
22200492,True,LAL,14400,130,36,21,15,12,1,9,21,3,1,4,1,7,8,5,8
22200492,False,CHA,14400,134,49,28,21,22,0,10,22,4,3,7,1,2,3,2,3
22200493,True,NYK,14400,112,44,23,21,8,0,4,10,2,2,4,3,1,3,3,4
22200493,False,PHI,14400,119,44,26,18,17,0,6,17,3,1,4,0,11,11,4,11
22200494,True,DAL,14400,124,36,26,10,8,1,4,9,4,1,5,0,3,3,2,3
22200494,False,LAL,14400,115,27,13,14,8,2,4,8,5,3,8,0,8,8,5,8
22200495,True,BOS,14400,139,44,22,22,21,0,9,21,1,3,4,1,7,7,3,8
22200495,False,MIL,14400,118,42,27,15,15,0,4,9,2,3,5,1,5,6,3,6
22200496,True,GSW,14400,123,43,32,11,8,2,17,41,6,1,7,1,6,7,6,7
22200496,False,MEM,14400,109,33,19,14,18,0,9,19,2,1,3,7,4,11,7,11
22200497,True,DEN,15900,128,49,28,21,14,0,11,27,3,4,7,1,2,3,2,3
22200497,False,PHX,15900,125,53,32,21,24,1,11,26,2,1,3,2,3,5,4,5
22200498,True,CLE,14400,117,55,31,24,13,2,10,24,5,5,10,2,2,4,3,4
22200498,False,BKN,14400,125,36,17,19,13,0,7,17,7,4,11,1,5,6,2,6
22200499,True,DET,15900,131,57,31,26,17,1,9,22,4,4,8,7,8,13,8,15
22200499,False,LAC,15900,142,62,38,24,27,0,9,20,3,5,8,0,15,15,8,15
22200500,True,MIA,14400,113,33,13,20,14,1,21,47,0,3,3,0,3,3,0,3
22200500,False,MIN,14400,110,39,18,21,13,0,8,18,3,1,4,1,3,4,2,4
22200501,True,CHI,14400,118,43,17,26,14,0,14,28,3,2,5,1,3,4,2,4
22200501,False,HOU,14400,133,45,27,18,13,0,13,31,1,1,2,0,3,3,3,3
22200502,True,NOP,14400,113,36,25,11,16,0,7,18,2,4,6,4,12,16,7,16
22200502,False,IND,14400,93,41,23,18,21,1,4,11,2,2,4,1,10,11,5,11
22200503,True,SAS,14400,126,55,29,26,14,0,13,28,1,3,4,2,10,9,6,12
22200503,False,UTA,14400,122,40,31,9,15,0,9,22,1,4,5,4,5,8,3,9
22200504,True,POR,14400,124,58,42,16,17,0,8,21,2,3,5,1,6,7,4,7
22200504,False,CHA,14400,113,50,27,23,23,0,13,30,5,2,7,0,3,3,2,3
22200505,True,ORL,14400,110,41,21,20,12,0,16,33,0,1,1,0,3,3,2,3
22200505,False,LAL,14400,129,45,29,16,7,3,11,28,4,3,7,2,4,6,4,6
22200506,True,WAS,14400,116,35,25,10,10,0,10,24,1,2,3,0,2,0,0,2
22200506,False,PHI,14400,111,35,25,10,13,1,6,12,0,2,2,1,2,3,1,3
22200507,True,BOS,14400,126,38,15,23,14,0,8,23,4,3,7,0,5,5,4,5
22200507,False,HOU,14400,102,26,10,16,11,0,6,14,4,1,5,0,2,2,2,2
22200508,True,IND,14400,129,33,23,10,9,0,7,16,0,2,2,0,4,3,2,4
22200508,False,ATL,14400,114,41,24,17,9,0,11,24,1,0,1,0,4,4,1,4
22200509,True,TOR,14400,113,45,29,16,22,0,9,18,2,2,4,0,4,4,1,4
22200509,False,LAC,14400,124,39,33,6,15,0,9,20,1,3,4,1,9,10,2,10
22200510,True,MEM,14400,108,43,27,16,22,0,8,18,2,3,5,0,3,3,2,3
22200510,False,PHX,14400,125,51,33,18,12,1,9,23,2,3,5,0,3,3,1,3
22200511,True,OKC,14400,130,46,36,10,13,1,6,13,2,4,6,2,3,5,3,5
22200511,False,SAS,14400,114,27,26,1,16,0,7,15,1,3,4,4,0,4,2,4
22200512,True,DAL,15900,126,56,30,26,4,1,14,29,1,2,3,1,10,10,0,11
22200512,False,NYK,15900,121,45,19,26,10,0,5,11,0,1,1,3,10,8,5,13
22200513,True,GSW,14400,110,29,24,5,10,0,10,23,2,0,2,1,3,4,3,4
22200513,False,CHA,14400,105,26,19,7,11,0,14,32,0,2,2,1,1,2,1,2
22200514,True,SAC,14400,106,28,17,11,13,0,10,22,2,0,2,0,2,2,1,2
22200514,False,DEN,14400,113,27,17,10,14,0,6,14,1,3,4,1,3,4,2,4
22200515,True,DET,14400,121,58,44,14,12,1,8,19,3,3,6,1,1,2,1,2
22200515,False,ORL,14400,101,53,27,26,15,0,6,12,4,3,7,2,11,9,5,13
22200516,True,WAS,14400,127,49,36,13,12,0,6,13,3,1,4,1,3,2,0,4
22200516,False,PHX,14400,102,53,34,19,8,0,9,19,3,4,7,0,4,2,0,4
22200517,True,ATL,14400,107,56,39,17,18,0,11,27,5,5,10,2,5,6,4,7
22200517,False,BKN,14400,108,70,58,12,14,1,5,10,5,1,6,0,7,5,2,7
22200518,True,MIA,14400,112,28,12,16,21,2,12,27,2,3,5,0,4,3,1,4
22200518,False,LAL,14400,98,52,29,23,12,1,1,2,3,0,3,0,5,5,1,5
22200519,True,CHI,15900,119,37,31,6,17,2,15,33,1,3,4,0,3,3,2,3
22200519,False,MIL,15900,113,44,36,8,17,1,4,8,3,0,3,4,2,6,6,6
22200520,True,NOP,14400,119,43,26,17,10,0,13,30,3,4,7,1,12,13,7,13
22200520,False,MIN,14400,118,36,25,11,16,2,5,11,2,1,3,2,4,5,3,6
22200521,True,GSW,14400,112,75,33,42,16,0,8,19,4,0,4,0,7,7,6,7
22200521,False,UTA,14400,107,52,23,29,13,1,8,21,2,2,4,1,1,2,2,2
22200522,True,SAC,14400,127,45,34,11,18,0,8,17,6,3,9,1,2,3,1,3
22200522,False,DEN,14400,126,44,31,13,11,1,12,26,1,2,3,0,1,1,1,1
22200523,True,CHA,14400,121,51,32,19,19,0,11,25,3,3,6,3,5,8,8,8
22200523,False,OKC,14400,113,37,22,15,22,1,13,27,3,3,6,0,7,7,1,7
22200524,True,IND,14400,135,48,35,13,13,0,14,33,1,1,2,1,2,3,1,3
22200524,False,CLE,14400,126,49,32,17,15,0,12,27,6,3,9,1,3,3,2,4
22200525,True,BOS,14400,116,43,25,18,22,1,9,18,3,2,5,4,6,8,6,10
22200525,False,LAC,14400,110,46,24,22,13,0,4,10,2,1,3,2,5,7,3,7
22200526,True,TOR,14400,106,48,30,18,22,0,7,16,3,2,5,0,8,7,2,8
22200526,False,MEM,14400,119,56,40,16,13,0,4,9,4,5,9,1,6,6,3,7
22200527,True,SAS,14400,122,41,24,17,11,1,10,23,2,7,9,0,3,3,2,3
22200527,False,NYK,14400,115,49,33,16,17,0,8,18,6,2,8,1,3,4,3,4
22200528,True,DAL,14400,129,29,21,8,9,1,4,10,0,0,0,0,7,6,6,7
22200528,False,HOU,14400,114,27,17,10,7,0,5,12,2,2,4,3,1,4,4,4
22200529,True,ORL,14400,100,35,12,23,16,2,19,38,4,2,6,1,3,4,2,4
22200529,False,WAS,14400,119,54,41,13,6,1,8,19,2,2,4,0,7,7,0,7
22200530,True,ATL,14400,121,57,40,17,20,0,14,29,2,1,3,0,2,0,0,2
22200530,False,LAL,14400,130,70,42,28,15,1,5,11,2,2,4,1,8,9,5,9
22200531,True,TOR,14400,113,39,28,11,24,1,5,10,2,5,7,3,9,9,4,12
22200531,False,PHX,14400,104,49,29,20,10,3,9,20,0,4,4,2,10,11,3,12
22200532,True,CHI,14400,132,58,31,27,16,0,14,33,1,1,2,2,10,8,5,12
22200532,False,DET,14400,118,53,39,14,11,1,9,23,2,3,5,0,3,3,1,3
22200533,True,MIL,14400,123,46,35,11,12,0,4,10,0,2,2,0,4,4,3,4
22200533,False,MIN,14400,114,48,24,24,21,0,7,15,2,1,3,0,6,3,0,6
22200534,True,NOP,14400,127,23,18,5,13,1,10,26,1,2,3,1,1,1,0,2
22200534,False,PHI,14400,116,28,20,8,6,0,0,0,0,1,1,0,3,3,0,3
22200535,True,DEN,14400,124,34,22,12,19,1,10,22,0,1,1,0,3,3,2,3
22200535,False,MIA,14400,119,31,23,8,19,0,14,34,1,1,2,2,2,3,1,4
22200536,True,GSW,14400,118,64,39,25,19,1,9,23,1,0,1,4,2,6,6,6
22200536,False,POR,14400,112,49,25,24,10,1,7,15,6,4,10,1,3,2,1,4
22200537,True,SAC,14400,126,53,29,24,13,0,14,34,2,0,2,0,3,3,2,3
22200537,False,UTA,14400,125,57,37,20,16,0,6,14,1,3,4,1,5,6,5,6
22200538,True,IND,14400,131,46,27,19,16,0,9,20,3,4,7,1,4,5,1,5
22200538,False,LAC,14400,130,52,28,24,20,0,4,8,5,4,9,0,3,2,0,3
22200539,True,CHA,14400,106,18,13,5,18,0,2,4,1,0,1,2,3,5,5,5
22200539,False,BKN,14400,123,22,17,5,12,0,13,31,1,0,1,1,2,3,2,3
22200540,True,CHI,14400,102,41,19,22,26,0,11,23,1,6,7,0,0,0,0,0
22200540,False,CLE,14400,103,46,36,10,13,1,7,15,10,1,11,0,2,1,1,2
22200541,True,HOU,14400,88,30,17,13,9,1,7,17,1,1,2,1,3,4,4,4
22200541,False,NYK,14400,108,27,11,16,15,0,8,19,1,3,4,1,1,2,1,2
22200542,True,SAS,14400,125,45,25,20,10,0,12,26,1,1,2,2,2,4,3,4
22200542,False,DAL,14400,126,39,33,6,15,1,20,45,2,0,2,0,2,2,0,2
22200543,True,MEM,14400,116,50,37,13,17,1,11,25,4,4,8,0,7,7,2,7
22200543,False,NOP,14400,101,46,26,20,11,1,3,6,3,3,6,0,9,9,6,9
22200544,True,MIN,14400,104,63,42,21,20,0,4,10,0,3,3,0,2,2,0,2
22200544,False,DET,14400,116,58,31,27,10,0,9,22,2,1,3,1,2,3,0,3
22200545,True,OKC,14400,96,49,39,10,13,1,7,15,1,6,7,1,3,4,2,4
22200545,False,PHI,14400,115,28,21,7,9,1,6,14,2,1,3,2,5,7,5,7
22200546,True,UTA,14400,123,53,30,23,16,0,3,8,2,3,5,1,3,4,0,4
22200546,False,MIA,14400,126,48,25,23,20,1,9,21,5,2,7,1,9,10,3,10
22200547,True,MEM,14400,118,48,29,19,19,0,13,28,4,3,7,2,6,8,5,8
22200547,False,SAC,14400,108,52,32,20,12,0,8,23,2,2,4,0,3,2,0,3
22200548,True,MIL,14400,95,56,38,18,15,0,7,15,2,3,5,1,3,3,1,4
22200548,False,WAS,14400,118,54,26,28,10,0,11,24,4,4,8,0,4,3,3,4
22200549,True,DEN,14400,123,37,19,18,8,0,11,27,1,0,1,0,6,5,0,6
22200549,False,BOS,14400,111,34,23,11,14,0,6,14,2,1,3,1,7,8,0,8
22200550,True,NYK,14400,102,45,27,18,6,0,5,11,2,1,3,2,6,7,4,8
22200550,False,PHX,14400,83,37,17,20,18,0,13,27,0,1,1,2,7,8,3,9
22200551,True,CHA,14400,115,44,27,17,17,0,10,24,3,3,6,3,4,4,1,7
22200551,False,LAL,14400,121,30,22,8,10,0,9,19,6,1,7,1,4,4,2,5
22200552,True,CLE,15900,145,55,34,21,11,0,13,30,3,0,3,3,10,12,8,13
22200552,False,CHI,15900,134,51,21,30,14,0,7,14,3,1,4,2,7,9,5,9
22200553,True,IND,14400,122,47,18,29,12,1,13,28,3,6,9,2,7,8,4,9
22200553,False,TOR,14400,114,60,46,14,19,0,8,17,3,4,7,2,7,8,3,9
22200554,True,PHI,14400,120,27,20,7,12,1,4,8,0,1,1,1,1,2,1,2
22200554,False,NOP,14400,111,33,21,12,5,1,7,15,1,2,3,0,0,0,0,0
22200555,True,BKN,14400,139,54,36,18,15,1,18,43,3,1,4,1,3,2,2,4
22200555,False,SAS,14400,103,44,35,9,8,0,5,11,1,2,3,2,2,4,2,4
22200556,True,HOU,14400,106,23,11,12,14,0,5,12,0,0,0,2,1,3,2,3
22200556,False,DAL,14400,111,38,27,11,8,2,6,14,2,2,4,0,3,3,0,3
22200557,True,MIN,14400,124,47,34,13,12,0,7,17,0,2,2,1,4,4,0,5
22200557,False,DEN,14400,111,35,19,16,14,1,7,17,2,2,4,0,1,1,0,1
22200558,True,GSW,17400,143,50,36,14,15,0,14,37,3,2,5,3,2,5,4,5
22200558,False,ATL,17400,141,50,26,24,23,0,19,43,0,3,3,0,2,2,1,2
22200559,True,POR,14400,135,26,24,2,17,0,9,23,1,2,3,1,5,6,4,6
22200559,False,DET,14400,106,36,25,11,10,0,6,13,2,2,4,1,3,4,2,4
22200560,True,LAC,14400,100,45,22,23,14,0,8,19,2,2,4,0,3,2,1,3
22200560,False,MIA,14400,110,29,13,16,10,1,6,15,3,3,6,1,6,5,2,7
22200561,True,MIL,14400,123,63,45,18,11,0,3,7,2,1,3,2,4,6,6,6
22200561,False,WAS,14400,113,49,30,19,8,0,16,32,3,5,8,0,3,3,1,3
22200562,True,OKC,14400,150,50,27,23,12,0,17,37,5,7,12,1,3,4,2,4
22200562,False,BOS,14400,117,53,27,26,16,0,10,24,3,2,5,2,5,7,4,7
22200563,True,UTA,14400,115,49,33,16,15,0,9,23,4,1,5,1,3,4,3,4
22200563,False,SAC,14400,117,63,29,34,17,0,11,23,3,0,3,0,0,0,0,0
22200564,True,CHA,14400,107,55,36,19,18,0,4,10,4,4,8,3,5,7,7,8
22200564,False,MEM,14400,131,63,39,24,16,0,14,32,4,7,11,1,9,9,5,10
22200565,True,CLE,14400,90,47,31,16,14,0,6,15,1,5,6,0,8,8,6,8
22200565,False,PHX,14400,88,28,16,12,15,0,11,26,0,2,2,0,0,0,0,0
22200566,True,ORL,14400,126,49,23,26,10,0,11,23,3,2,5,2,3,3,2,5
22200566,False,OKC,14400,115,56,32,24,12,1,9,19,1,2,3,2,2,3,3,4
22200567,True,PHI,15900,129,49,33,16,19,1,11,24,5,3,8,4,7,8,4,11
22200567,False,IND,15900,126,59,39,20,25,0,12,26,6,4,10,1,5,6,5,6
22200568,True,NYK,14400,117,50,33,17,9,2,13,28,3,2,5,0,9,3,2,9
22200568,False,SAS,14400,114,59,44,15,6,1,18,40,3,1,4,0,5,3,2,5
22200569,True,TOR,15900,101,48,25,23,21,2,11,25,2,3,5,0,3,3,0,3
22200569,False,MIL,15900,104,65,38,27,12,1,2,5,4,2,6,0,9,9,3,9
22200570,True,CHI,14400,121,46,30,16,17,0,9,19,1,2,3,0,1,1,1,1
22200570,False,BKN,14400,112,50,39,11,20,0,6,14,1,1,2,0,1,1,0,1
22200571,True,MIN,14400,113,42,21,21,8,2,8,20,3,2,5,1,4,5,4,5
22200571,False,POR,14400,106,42,30,12,15,0,7,17,3,4,7,4,10,11,7,14
22200572,True,NOP,14400,119,41,24,17,14,1,5,13,3,3,6,2,6,8,8,8
22200572,False,HOU,14400,108,31,16,15,15,2,6,15,3,5,8,1,1,2,2,2
22200573,True,GSW,14400,119,36,27,9,8,0,17,41,2,1,3,1,7,7,6,8
22200573,False,DET,14400,122,30,19,11,13,0,9,21,5,2,7,1,2,3,3,3
22200574,True,LAL,14400,112,48,33,15,17,0,6,13,2,3,5,2,3,5,1,5
22200574,False,MIA,14400,109,30,25,5,16,0,9,19,4,2,6,2,7,9,4,9
22200575,True,SAC,14400,117,32,21,11,19,0,12,29,1,1,2,2,1,3,3,3
22200575,False,ATL,14400,120,32,26,6,19,0,10,23,3,1,4,1,4,5,5,5
22200576,True,ORL,14400,115,55,30,25,14,2,9,19,2,0,2,2,7,9,4,9
22200576,False,MEM,14400,123,61,33,28,11,2,8,17,3,3,6,1,12,13,8,13
22200577,True,DAL,14400,95,44,20,24,15,1,11,24,2,0,2,4,5,9,5,9
22200577,False,BOS,14400,124,51,27,24,14,0,3,6,4,2,6,5,7,11,6,12
22200578,True,HOU,14400,114,51,21,30,8,2,11,29,3,4,7,1,5,5,3,6
22200578,False,UTA,14400,131,52,30,22,13,1,14,34,3,4,7,1,10,8,4,11
22200579,True,DEN,14400,122,43,27,16,16,0,4,11,0,2,2,1,3,3,2,4
22200579,False,LAC,14400,91,45,20,25,14,0,4,9,3,1,4,0,2,0,0,2
22200580,True,IND,14400,108,48,25,23,12,1,10,25,0,4,4,0,3,3,2,3
22200580,False,POR,14400,99,33,23,10,6,3,7,16,2,1,3,2,5,6,3,7
22200581,True,PHI,14400,112,36,20,16,13,2,8,19,4,0,4,0,4,3,1,4
22200581,False,CHI,14400,126,39,26,13,12,1,7,19,0,1,1,2,4,6,3,6
22200582,True,TOR,14400,108,50,27,23,23,0,7,15,2,2,4,1,16,15,6,17
22200582,False,NYK,14400,112,56,39,17,6,0,7,18,3,3,6,2,18,18,9,20
22200583,True,MIL,14400,109,60,31,29,12,0,10,25,2,2,4,0,0,0,0,0
22200583,False,CHA,14400,138,42,18,24,16,0,13,30,4,2,6,1,3,4,2,4
22200584,True,OKC,14400,127,44,30,14,10,1,3,8,3,4,7,2,6,7,3,8
22200584,False,WAS,14400,110,43,27,16,11,0,8,17,1,7,8,0,5,5,2,5
22200585,True,SAS,14400,121,46,31,15,13,1,12,24,6,0,6,1,8,6,3,9
22200585,False,DET,14400,109,50,33,17,15,0,9,21,3,4,7,0,3,1,0,3
22200586,True,NOP,14400,102,42,30,12,13,1,4,10,2,1,3,0,3,3,2,3
22200586,False,BKN,14400,108,34,28,6,12,0,5,14,2,0,2,1,2,3,1,3
22200587,True,MIN,14400,128,44,34,10,15,0,11,26,0,3,3,1,5,6,5,6
22200587,False,LAC,14400,115,27,18,9,26,1,5,12,3,1,4,2,0,2,2,2
22200588,True,DEN,14400,121,29,25,4,12,0,12,31,2,1,3,2,0,2,2,2
22200588,False,CLE,14400,108,37,21,16,17,0,5,11,3,1,4,4,1,5,3,5
22200589,True,PHX,14400,96,44,26,18,11,0,8,17,2,1,3,0,4,4,2,4
22200589,False,MIA,14400,104,37,26,11,22,0,4,11,0,5,5,1,4,5,4,5
22200590,True,LAL,14400,130,47,34,13,9,0,6,12,0,1,1,0,3,3,1,3
22200590,False,ATL,14400,114,53,32,21,17,0,12,26,0,3,3,1,1,2,1,2
22200591,True,SAS,14400,116,52,36,16,12,0,19,42,0,3,3,0,1,1,0,1
22200591,False,BOS,14400,121,53,39,14,15,0,6,14,1,2,3,0,3,3,1,3
22200592,True,CHI,14400,126,34,15,19,10,0,19,42,3,0,3,1,5,6,2,6
22200592,False,UTA,14400,118,42,27,15,6,0,7,15,0,1,1,1,3,4,2,4
22200593,True,DAL,14400,127,42,27,15,10,1,15,35,2,1,3,0,3,3,2,3
22200593,False,NOP,14400,117,37,14,23,18,1,12,24,1,1,2,0,3,2,1,3
22200594,True,GSW,14400,101,42,27,15,8,1,8,21,0,1,1,2,2,4,2,4
22200594,False,ORL,14400,115,33,9,24,20,1,10,24,2,1,3,1,3,4,1,4
22200595,True,SAC,14400,134,53,39,14,11,1,8,21,0,0,0,0,4,4,3,4
22200595,False,LAL,14400,136,56,36,20,11,0,10,22,3,2,5,2,4,5,5,6
22200596,True,DET,14400,111,55,30,25,16,0,6,12,2,2,4,2,1,2,1,3
22200596,False,PHI,14400,123,47,34,13,25,0,5,12,3,0,3,0,2,2,1,2
22200597,True,TOR,14400,117,36,22,14,15,2,6,13,1,3,4,2,9,10,5,11
22200597,False,POR,14400,105,34,23,11,5,0,8,17,8,2,10,0,12,12,6,12
22200598,True,IND,14400,116,37,28,9,26,1,4,10,2,4,6,1,2,3,1,3
22200598,False,CHA,14400,111,36,20,16,15,0,6,12,6,2,8,0,5,5,2,5
22200599,True,MIA,14400,101,44,25,19,15,2,3,7,1,2,3,0,3,3,1,3
22200599,False,BKN,14400,102,56,35,21,9,0,6,16,4,1,5,0,3,3,0,3
22200600,True,MEM,14400,123,38,22,16,24,0,11,23,2,2,4,0,5,5,5,5
22200600,False,UTA,14400,118,49,33,16,15,1,15,36,0,2,2,0,1,1,0,1
22200601,True,HOU,14400,96,32,15,17,9,1,5,10,4,0,4,1,2,3,1,3
22200601,False,MIN,14400,104,33,18,15,17,0,5,10,0,3,3,0,4,4,3,4
22200602,True,OKC,14400,120,51,24,27,8,3,1,2,1,4,5,3,2,4,3,5
22200602,False,DAL,14400,109,38,29,9,9,3,3,9,1,1,2,1,5,5,4,6
22200603,True,PHX,14400,98,35,22,13,14,0,15,36,2,1,3,0,3,3,1,3
22200603,False,CLE,14400,112,43,35,8,15,0,11,26,1,3,4,0,5,5,2,5
22200604,True,LAC,14400,108,42,31,11,13,0,8,17,3,1,4,4,4,7,4,8
22200604,False,ATL,14400,112,58,41,17,15,1,10,21,2,3,5,1,6,4,2,7
22200605,True,WAS,14400,112,29,16,13,15,2,13,32,2,0,2,1,0,1,0,1
22200605,False,NOP,14400,132,36,21,15,19,3,9,20,3,1,4,2,5,7,5,7
22200606,True,BOS,14400,107,50,31,19,13,0,9,21,4,2,6,1,4,5,2,5
22200606,False,CHI,14400,99,49,24,25,20,0,12,26,5,3,8,2,16,17,11,18
22200607,True,NYK,14400,107,54,26,28,14,0,13,30,4,2,6,4,14,17,10,18
22200607,False,MIL,14400,111,73,42,31,8,1,8,20,2,3,5,1,6,7,2,7
22200608,True,MEM,14400,121,62,43,19,17,0,16,35,2,0,2,3,4,6,3,7
22200608,False,SAS,14400,113,55,42,13,10,0,13,29,1,4,5,2,4,6,2,6
22200609,True,DEN,14400,122,43,30,13,20,0,8,18,2,0,2,1,1,2,1,2
22200609,False,LAL,14400,109,45,28,17,17,1,7,15,2,4,6,2,3,5,2,5
22200610,True,SAC,14400,136,33,21,12,7,0,6,15,2,2,4,1,1,2,2,2
22200610,False,ORL,14400,111,27,17,10,22,0,11,24,0,0,0,2,5,7,5,7
22200611,True,MIA,14400,112,44,23,21,22,1,4,8,3,2,5,1,7,7,3,8
22200611,False,OKC,14400,111,56,29,27,12,2,7,14,7,2,9,1,2,3,2,3
22200612,True,PHI,14400,147,49,29,20,15,0,8,16,0,4,4,1,4,5,2,5
22200612,False,DET,14400,116,34,21,13,21,1,10,25,2,4,6,0,3,2,2,3
22200613,True,TOR,14400,132,56,34,22,16,1,6,14,4,1,5,3,10,11,9,13
22200613,False,CHA,14400,120,61,33,28,20,0,10,24,3,2,5,2,10,10,5,12
22200614,True,UTA,14400,116,50,28,22,5,0,15,33,1,1,2,0,4,4,4,4
22200614,False,CLE,14400,114,52,31,21,17,0,14,34,2,4,6,2,3,3,3,5
22200615,True,GSW,14400,113,59,35,24,25,1,9,22,6,4,10,3,4,7,6,7
22200615,False,PHX,14400,125,44,22,22,17,1,6,14,1,5,6,0,3,3,3,3
22200616,True,POR,14400,106,42,30,12,16,0,9,19,3,2,5,3,4,7,5,7
22200616,False,ORL,14400,109,39,19,20,11,1,13,27,2,2,4,3,3,5,3,6
22200617,True,LAC,14400,113,28,16,12,17,1,5,11,2,1,3,3,4,6,4,7
22200617,False,DAL,14400,101,37,27,10,11,0,7,15,2,2,4,1,3,4,2,4
22200618,True,DET,14400,135,51,30,21,21,0,14,32,2,3,5,0,6,6,2,6
22200618,False,MIN,14400,118,38,24,14,16,1,11,29,3,2,5,2,6,7,2,8
22200619,True,WAS,14400,100,52,33,19,16,1,7,15,2,2,4,0,5,3,0,5
22200619,False,CHI,14400,97,48,31,17,7,0,3,7,5,3,8,1,3,4,3,4
22200620,True,ATL,14400,105,58,27,31,15,1,16,38,1,1,2,0,6,6,1,6
22200620,False,MIL,14400,114,51,34,17,10,0,12,28,4,1,5,1,4,5,4,5
22200621,True,BOS,14400,125,43,30,13,14,0,10,24,4,2,6,2,2,4,3,4
22200621,False,NOP,14400,114,40,19,21,9,0,8,17,1,2,3,0,1,1,0,1
22200622,True,NYK,14400,119,31,17,14,10,1,4,11,1,1,2,1,5,4,2,6
22200622,False,IND,14400,113,44,22,22,16,0,11,30,0,4,4,0,0,0,0,0
22200623,True,MEM,14400,135,60,42,18,16,0,19,46,2,2,4,1,3,4,3,4
22200623,False,SAS,14400,129,50,39,11,9,0,7,15,0,1,1,3,4,7,6,7
22200624,True,DEN,14400,126,43,30,13,20,0,11,26,2,3,5,2,3,5,5,5
22200624,False,PHX,14400,97,30,19,11,17,2,9,21,3,0,3,2,4,5,2,6
22200625,True,SAC,14400,135,30,23,7,8,0,8,20,2,0,2,0,4,4,2,4
22200625,False,HOU,14400,115,28,24,4,5,0,13,32,4,2,6,0,3,3,1,3
22200626,True,PHI,14400,114,41,28,13,11,0,8,20,0,2,2,0,6,6,1,6
22200626,False,OKC,14400,133,62,40,22,10,2,9,20,1,3,4,1,7,7,4,8
22200627,True,BKN,14400,98,41,27,14,16,0,10,25,3,6,9,0,10,8,1,10
22200627,False,BOS,14400,109,51,33,18,8,0,5,10,7,2,9,2,6,8,3,8
22200628,True,MIA,14400,108,45,18,27,18,0,14,31,6,1,7,0,10,8,3,10
22200628,False,MIL,14400,102,55,36,19,15,0,7,18,2,2,4,1,2,2,2,3
22200629,True,TOR,14400,124,33,17,16,20,1,7,15,2,2,4,0,3,3,2,3
22200629,False,CHA,14400,114,40,26,14,11,0,11,28,6,2,8,1,3,4,3,4
22200630,True,LAL,17400,115,46,23,23,16,1,7,14,4,1,5,1,4,5,3,5
22200630,False,DAL,17400,119,49,33,16,13,1,17,39,4,2,6,0,5,5,3,5
22200631,True,POR,14400,113,49,36,13,16,0,10,22,0,2,2,0,5,5,4,5
22200631,False,CLE,14400,119,53,30,23,16,1,7,16,2,2,4,2,5,7,2,7
22200632,True,DET,14400,110,43,30,13,17,0,10,23,3,3,6,0,11,10,3,11
22200632,False,NOP,14400,116,47,31,16,11,0,9,21,4,1,5,2,11,10,3,13
22200633,True,IND,14400,111,46,32,14,14,0,7,14,4,4,8,1,6,6,2,7
22200633,False,ATL,14400,113,43,28,15,15,0,3,7,2,2,4,2,4,4,2,6
22200634,True,WAS,14400,108,51,35,16,5,1,7,15,6,3,9,1,5,4,3,6
22200634,False,NYK,14400,112,57,33,24,8,1,7,16,0,3,3,2,3,2,1,5
22200635,True,SAS,14400,113,39,21,18,11,0,10,22,2,3,5,1,1,2,2,2
22200635,False,GSW,14400,144,49,32,17,16,0,10,25,2,5,7,1,5,6,3,6
22200636,True,CHI,14400,110,45,26,19,12,1,5,10,3,0,3,0,3,2,0,3
22200636,False,OKC,14400,124,46,21,25,11,0,13,26,0,2,2,0,3,3,1,3
22200637,True,MIN,14400,121,45,36,9,22,1,17,38,0,3,3,0,3,3,2,3
22200637,False,PHX,14400,116,53,36,17,11,0,8,19,0,4,4,0,6,6,4,6
22200638,True,UTA,14400,112,46,32,14,11,0,3,7,3,5,8,3,4,7,6,7
22200638,False,ORL,14400,108,28,19,9,19,1,9,20,2,2,4,3,1,4,4,4
22200639,True,LAC,14400,103,47,29,18,12,0,7,14,1,3,4,0,3,3,1,3
22200639,False,DEN,14400,115,57,41,16,11,0,10,25,1,1,2,3,6,8,3,9
22200640,True,SAC,14400,139,45,27,18,26,0,4,11,2,1,3,2,5,7,4,7
22200640,False,HOU,14400,114,35,25,10,12,0,10,25,2,0,2,1,1,2,1,2
22200641,True,MIA,14400,111,41,16,25,15,0,21,48,1,3,4,4,9,12,5,13
22200641,False,MIL,14400,95,53,41,12,14,0,2,5,2,3,5,0,1,1,1,1
22200642,True,CHA,14400,106,39,17,22,13,0,10,20,2,2,4,0,7,5,1,7
22200642,False,BOS,14400,122,48,31,17,10,0,12,30,3,3,6,1,8,5,4,9
22200643,True,IND,14400,112,40,21,19,12,1,6,15,5,3,8,0,4,4,3,4
22200643,False,MEM,14400,130,47,33,14,14,0,8,19,0,3,3,1,1,2,2,2
22200644,True,TOR,14400,103,50,34,16,14,0,2,4,4,4,8,0,3,3,2,3
22200644,False,ATL,14400,114,44,27,17,13,0,8,16,1,0,1,0,4,4,2,4
22200645,True,MIN,14400,110,23,18,5,18,1,10,21,1,2,3,0,0,0,0,0
22200645,False,CLE,14400,102,27,22,5,6,1,3,6,1,2,3,0,6,6,4,6
22200646,True,UTA,14400,117,41,25,16,11,0,8,19,0,0,0,0,2,2,0,2
22200646,False,PHI,14400,118,36,21,15,14,1,10,24,3,2,5,1,5,4,1,6
22200647,True,POR,14400,136,31,13,18,17,0,14,32,1,2,3,1,4,5,3,5
22200647,False,DAL,14400,119,39,25,14,6,0,13,28,0,2,2,0,2,2,1,2
22200648,True,DET,14400,104,47,32,15,13,0,9,21,2,2,4,2,1,3,1,3
22200648,False,NYK,14400,117,40,18,22,10,3,4,10,0,1,1,1,5,4,2,6
22200649,True,LAC,14400,121,54,36,18,17,0,14,32,2,5,7,1,3,4,3,4
22200649,False,HOU,14400,100,50,34,16,13,0,4,8,3,2,5,1,3,4,2,4
22200650,True,CHI,14400,132,36,14,22,15,1,7,15,2,4,6,0,3,3,1,3
22200650,False,GSW,14400,118,53,33,20,13,0,9,23,0,2,2,2,1,3,2,3
22200651,True,BKN,14400,102,45,33,12,13,0,8,19,3,4,7,0,1,1,1,1
22200651,False,OKC,14400,112,42,28,14,10,2,7,17,4,2,6,0,6,6,4,6
22200652,True,SAS,14400,119,36,27,9,13,0,8,18,0,1,1,3,2,5,2,5
22200652,False,SAC,14400,132,42,30,12,10,0,11,28,0,2,2,1,1,2,1,2
22200653,True,DEN,14400,119,47,27,20,11,0,6,14,6,3,9,1,3,4,1,4
22200653,False,ORL,14400,116,49,21,28,24,0,10,21,1,4,5,1,8,9,4,9
22200654,True,POR,14400,140,35,20,15,6,1,12,27,1,0,1,1,1,2,1,2
22200654,False,DAL,14400,123,48,29,19,17,0,5,10,3,1,4,1,4,5,3,5
22200655,True,LAL,14400,112,52,36,16,10,2,7,16,1,3,4,0,1,1,1,1
22200655,False,PHI,14400,113,54,42,12,11,1,10,25,2,0,2,0,4,4,1,4
22200656,True,CHA,14400,118,32,13,19,12,0,12,29,3,2,5,2,5,7,4,7
22200656,False,BOS,14400,130,47,31,16,5,0,10,25,3,2,5,0,5,5,3,5
22200657,True,MIL,14400,132,30,17,13,14,0,6,15,1,3,4,0,1,1,0,1
22200657,False,IND,14400,119,48,24,24,9,0,7,15,2,2,4,0,1,1,0,1
22200658,True,CLE,14400,113,32,26,6,6,0,7,17,1,2,3,0,3,3,1,3
22200658,False,NOP,14400,103,27,18,9,14,0,9,21,1,1,2,1,1,2,1,2
22200659,True,NYK,15900,121,57,35,22,8,0,6,13,8,5,13,3,16,17,5,19
22200659,False,TOR,15900,123,68,43,25,18,0,5,11,3,4,7,1,12,13,4,13
22200660,True,WAS,14400,118,28,13,15,9,0,10,25,2,2,4,0,6,6,2,6
22200660,False,GSW,14400,127,43,24,19,17,1,10,24,0,4,4,1,7,7,3,8
22200661,True,ATL,14400,121,52,30,22,16,1,7,17,1,5,6,0,5,5,3,5
22200661,False,MIA,14400,113,39,29,10,23,0,12,24,2,3,5,3,6,9,6,9
22200662,True,MIN,14400,125,49,31,18,19,0,12,30,4,1,5,3,8,10,6,11
22200662,False,UTA,14400,126,54,37,17,9,0,9,22,5,3,8,3,4,6,6,7
22200663,True,MEM,14400,136,53,36,17,17,0,20,48,0,4,4,0,1,1,1,1
22200663,False,PHX,14400,106,50,30,20,13,1,3,6,2,1,3,0,2,2,1,2
22200664,True,LAL,14400,140,45,33,12,12,1,15,32,2,1,3,3,3,5,4,6
22200664,False,HOU,14400,132,39,20,19,11,0,8,18,0,2,2,0,1,0,0,1
22200665,True,MIL,14400,130,58,40,18,13,0,5,11,5,4,9,3,8,10,7,11
22200665,False,TOR,14400,122,49,29,20,21,0,15,33,5,2,7,1,7,8,4,8
22200666,True,SAS,14400,106,44,31,13,17,1,11,24,3,3,6,1,1,2,2,2
22200666,False,BKN,14400,98,35,20,15,12,2,12,25,3,3,6,2,3,5,5,5
22200667,True,DEN,14400,122,39,20,19,13,0,11,25,1,2,3,0,0,0,0,0
22200667,False,POR,14400,113,48,32,16,14,0,12,31,2,0,2,0,1,1,1,1
22200668,True,LAC,14400,110,34,22,12,15,0,10,23,2,2,4,0,0,0,0,0
22200668,False,PHI,14400,120,35,22,13,19,0,8,21,1,3,4,1,1,2,2,2
22200669,True,NYK,14400,105,52,21,31,11,0,12,26,5,2,7,7,8,13,7,15
22200669,False,WAS,14400,116,42,29,13,14,1,14,33,3,1,4,4,15,17,6,19
22200670,True,DAL,14400,122,52,36,16,12,1,8,19,6,4,10,1,5,5,1,6
22200670,False,ATL,14400,130,44,19,25,11,1,11,24,2,3,5,1,7,5,3,8
22200671,True,HOU,14400,117,35,20,15,11,2,15,33,4,0,4,0,1,0,0,1
22200671,False,CHA,14400,122,42,26,16,27,0,4,10,2,4,6,0,4,3,0,4
22200672,True,MEM,14400,115,46,28,18,16,0,11,24,2,2,4,5,3,6,5,8
22200672,False,CLE,14400,114,50,35,15,7,1,9,21,1,3,4,1,0,1,1,1
22200673,True,NOP,14400,98,42,27,15,11,1,6,16,1,2,3,1,2,2,1,3
22200673,False,MIA,14400,124,25,11,14,15,1,10,22,4,1,5,1,6,7,4,7
22200674,True,OKC,14400,126,56,34,22,15,1,2,5,3,2,5,0,6,6,4,6
22200674,False,IND,14400,106,53,30,23,17,2,2,4,1,2,3,2,5,7,5,7
22200675,True,UTA,14400,126,49,33,16,10,1,16,42,1,2,3,0,4,4,3,4
22200675,False,LAC,14400,103,47,33,14,9,0,10,24,1,1,2,2,1,3,1,3
22200676,True,DEN,14400,122,41,26,15,21,0,11,24,2,1,3,2,2,4,2,4
22200676,False,MIN,14400,118,42,33,9,14,1,6,13,2,0,2,0,2,2,2,2
22200677,True,LAL,14400,111,50,35,15,10,0,6,14,4,2,6,1,2,3,1,3
22200677,False,SAC,14400,116,47,29,18,17,0,9,20,2,0,2,1,4,5,1,5
22200678,True,DET,14400,108,48,36,12,16,0,8,16,5,4,9,5,5,10,6,10
22200678,False,CHI,14400,126,49,30,19,21,0,12,26,4,3,7,0,9,9,7,9
22200679,True,BOS,15900,121,64,30,34,14,0,4,10,6,5,11,5,10,13,10,15
22200679,False,GSW,15900,118,78,48,30,17,0,16,42,3,3,6,4,4,8,6,8
22200680,True,MIN,14400,128,44,29,15,15,1,5,13,2,2,4,1,6,6,4,7
22200680,False,TOR,14400,126,42,24,18,14,1,4,9,1,4,5,1,3,3,2,4
22200681,True,PHX,14400,117,46,35,11,13,0,5,10,5,2,7,0,5,5,4,5
22200681,False,BKN,14400,112,38,29,9,10,0,11,26,2,0,2,0,5,5,3,5
22200682,True,POR,14400,95,24,19,5,12,0,12,29,2,1,3,3,2,5,3,5
22200682,False,PHI,14400,105,27,17,10,16,0,7,15,0,1,1,0,4,4,2,4
22200683,True,ORL,14400,123,39,26,13,5,0,5,11,2,2,4,1,2,3,2,3
22200683,False,NOP,14400,110,41,25,16,23,0,7,15,7,2,9,0,3,2,0,3
22200684,True,ATL,14400,139,37,25,12,12,0,23,50,3,2,5,1,4,4,3,5
22200684,False,NYK,14400,124,50,34,16,8,0,3,7,4,2,6,0,4,4,2,4
22200685,True,CLE,14400,114,47,25,22,16,0,10,25,3,3,6,1,5,3,2,6
22200685,False,GSW,14400,120,41,25,16,11,0,11,28,3,4,7,2,4,5,4,6
22200686,True,DAL,14400,115,36,23,13,12,0,11,26,6,3,9,2,2,3,2,4
22200686,False,MIA,14400,90,30,11,19,11,0,13,27,0,0,0,1,2,3,2,3
22200687,True,SAS,14400,126,28,24,4,11,0,10,20,4,0,4,0,5,5,3,5
22200687,False,LAC,14400,131,39,30,9,9,0,16,33,1,2,3,2,1,3,3,3
22200688,True,DEN,14400,134,36,21,15,19,0,10,23,1,3,4,0,2,0,0,2
22200688,False,IND,14400,111,33,20,13,17,2,6,15,4,3,7,3,0,3,2,3
22200689,True,UTA,14400,106,54,29,25,10,0,3,6,5,2,7,1,4,5,2,5
22200689,False,BKN,14400,117,55,30,25,13,3,9,24,2,5,7,1,6,3,1,7
22200690,True,LAL,14400,122,44,31,13,11,1,6,15,2,4,6,0,10,9,3,10
22200690,False,MEM,14400,121,54,35,19,14,0,14,31,3,3,6,1,4,4,1,5
22200691,True,SAC,14400,118,60,31,29,11,0,11,26,3,0,3,1,2,3,1,3
22200691,False,OKC,14400,113,55,36,19,17,3,6,14,3,2,5,0,4,4,1,4
22200692,True,TOR,14400,104,58,35,23,17,1,9,19,5,3,8,1,3,4,4,4
22200692,False,BOS,14400,106,55,47,8,19,2,11,26,3,5,8,1,4,5,2,5
22200693,True,WAS,14400,138,28,26,2,11,1,17,41,3,1,4,0,1,1,0,1
22200693,False,ORL,14400,118,35,26,9,5,0,10,22,0,2,2,1,2,3,3,3
22200694,True,ATL,14400,118,28,19,9,15,0,17,36,0,2,2,0,4,4,4,4
22200694,False,CHA,14400,122,29,20,9,17,0,5,13,1,1,2,0,1,1,1,1
22200695,True,CLE,14400,114,58,30,28,16,1,10,21,2,3,5,0,5,5,2,5
22200695,False,MIL,14400,102,49,33,16,12,0,9,20,1,0,1,1,3,4,2,4
22200696,True,MIN,14400,113,42,30,12,21,0,6,15,1,4,5,1,4,5,3,5
22200696,False,HOU,14400,104,43,20,23,10,1,6,14,2,3,5,1,1,2,2,2
22200697,True,PHX,14400,112,54,34,20,11,0,4,9,3,3,6,1,5,6,2,6
22200697,False,IND,14400,107,45,31,14,19,1,9,20,0,2,2,0,9,9,4,9
22200698,True,SAC,14400,127,58,43,15,13,3,9,21,1,2,3,1,5,6,3,6
22200698,False,PHI,14400,129,53,34,19,16,0,7,16,1,1,2,2,5,7,5,7
22200699,True,MIA,14400,100,26,13,13,19,1,8,18,3,3,6,1,1,1,0,2
22200699,False,NOP,14400,96,35,17,18,24,1,3,7,1,2,3,0,5,5,2,5
22200700,True,TOR,14400,125,34,16,18,26,0,12,29,3,2,5,4,6,9,5,10
22200700,False,NYK,14400,116,52,33,19,10,1,4,10,9,1,10,2,9,11,6,11
22200701,True,DAL,14400,98,30,16,14,2,0,7,16,1,1,2,1,2,3,1,3
22200701,False,LAC,14400,112,33,17,16,12,0,4,8,1,2,3,1,2,1,0,3
22200702,True,DEN,14400,99,62,47,15,14,0,4,9,0,1,1,3,2,4,0,5
22200702,False,OKC,14400,101,52,37,15,12,2,4,8,4,3,7,0,3,3,2,3
22200703,True,PHX,14400,112,46,31,15,17,0,13,29,1,1,2,0,3,3,3,3
22200703,False,MEM,14400,110,51,31,20,20,1,7,15,0,0,0,2,6,8,5,8
22200704,True,GSW,14400,116,40,27,13,14,0,2,6,3,1,4,1,2,3,3,3
22200704,False,BKN,14400,120,35,22,13,15,1,8,21,2,0,2,0,2,2,1,2
22200705,True,POR,14400,112,31,20,11,12,2,9,21,4,1,5,0,4,4,3,4
22200705,False,LAL,14400,121,38,21,17,14,1,8,17,2,3,5,0,4,4,1,4
22200706,True,DET,14400,130,68,28,40,26,0,10,26,0,6,6,1,11,10,6,12
22200706,False,MIL,14400,150,63,36,27,15,0,8,19,3,4,7,2,13,14,9,15
22200707,True,ORL,14400,113,45,17,28,19,0,15,33,0,0,0,3,3,6,6,6
22200707,False,BOS,14400,98,50,33,17,13,0,9,21,5,3,8,3,6,8,4,9
22200708,True,CHI,14400,111,55,35,20,16,0,9,18,2,1,3,0,4,4,4,4
22200708,False,ATL,14400,100,47,34,13,9,0,4,8,3,0,3,3,2,5,3,5
22200709,True,HOU,14400,119,48,27,21,10,2,15,35,3,3,6,0,4,4,3,4
22200709,False,MIN,14400,114,33,22,11,18,0,11,28,2,2,4,0,3,3,1,3
22200710,True,UTA,14400,120,45,33,12,13,0,11,25,3,5,8,2,7,7,1,9
22200710,False,CHA,14400,102,60,34,26,21,0,6,13,0,3,3,2,7,7,2,9
22200711,True,POR,14400,147,34,29,5,15,0,18,47,5,3,8,0,2,2,1,2
22200711,False,SAS,14400,127,40,26,14,18,1,15,32,2,0,2,3,0,3,3,3
22200712,True,SAC,14400,133,51,37,14,12,1,10,26,2,2,4,1,5,6,5,6
22200712,False,MEM,14400,100,29,17,12,12,0,9,19,1,0,1,0,1,1,1,1
22200713,True,IND,14400,116,42,33,9,16,1,11,24,4,2,6,2,5,6,3,7
22200713,False,CHI,14400,110,52,31,21,11,0,10,20,4,2,6,2,7,8,4,9
22200714,True,MIA,14400,98,34,14,20,9,2,6,14,3,2,5,0,1,0,0,1
22200714,False,BOS,14400,95,51,33,18,7,0,5,11,2,0,2,1,5,4,1,6
22200715,True,NYK,14400,105,44,28,16,11,1,8,19,2,2,4,1,6,6,4,7
22200715,False,CLE,14400,103,51,28,23,16,0,8,21,5,4,9,0,9,8,7,9
22200716,True,NOP,14400,98,36,18,18,11,1,6,12,3,2,5,2,2,4,4,4
22200716,False,DEN,14400,99,34,23,11,10,0,4,9,2,1,3,1,4,5,4,5
22200717,True,DAL,14400,126,55,40,15,10,0,4,9,1,3,4,0,1,1,1,1
22200717,False,WAS,14400,127,50,31,19,12,0,10,22,3,3,6,0,4,2,1,4
22200718,True,PHX,14400,128,49,37,12,10,0,14,33,2,1,3,2,6,6,4,8
22200718,False,CHA,14400,97,49,27,22,12,0,7,17,0,3,3,2,3,5,2,5
22200719,True,LAL,14400,115,48,26,22,11,0,5,14,3,1,4,2,2,4,3,4
22200719,False,LAC,14400,133,51,25,26,11,0,16,35,1,0,1,1,3,4,3,4
22200720,True,ORL,14400,126,42,23,19,14,0,4,9,4,2,6,3,1,4,2,4
22200720,False,IND,14400,120,37,22,15,16,0,7,16,1,2,3,2,0,2,1,2
22200721,True,PHI,14400,137,31,21,10,15,0,4,10,2,3,5,0,1,1,0,1
22200721,False,BKN,14400,133,35,19,16,10,0,16,39,4,0,4,0,1,1,0,1
22200722,True,HOU,14400,103,50,31,19,19,0,9,23,3,3,6,1,6,4,2,7
22200722,False,WAS,14400,108,58,44,14,17,0,13,28,2,6,8,0,5,4,2,5
22200723,True,MIL,14400,107,61,39,22,21,0,11,26,1,2,3,0,2,2,0,2
22200723,False,DEN,14400,99,40,24,16,14,1,7,16,3,2,5,0,2,1,0,2
22200724,True,NOP,14400,102,43,28,15,12,0,7,19,2,3,5,1,2,3,2,3
22200724,False,MIN,14400,111,45,28,17,15,0,5,10,3,2,5,1,3,4,4,4
22200725,True,OKC,14400,132,47,28,19,21,1,3,9,2,1,3,0,5,5,1,5
22200725,False,ATL,14400,137,42,31,11,6,0,6,12,2,4,6,2,1,3,2,3
22200726,True,GSW,14400,122,43,29,14,16,1,12,32,4,2,6,1,5,4,3,6
22200726,False,MEM,14400,120,43,24,19,23,0,8,18,1,1,2,1,4,5,3,5
22200727,True,POR,14400,134,40,23,17,18,0,4,10,3,3,6,2,5,7,4,7
22200727,False,UTA,14400,124,32,25,7,16,0,7,16,4,3,7,0,1,0,0,1
22200728,True,SAC,14400,95,34,25,9,8,0,3,8,3,3,6,0,5,5,2,5
22200728,False,TOR,14400,113,28,21,7,19,1,7,17,0,3,3,1,2,3,1,3
22200729,True,LAL,14400,113,52,38,14,16,1,5,11,3,4,7,3,3,6,5,6
22200729,False,SAS,14400,104,36,22,14,13,0,9,19,1,3,4,2,4,5,3,6
22200730,True,BOS,15900,117,53,33,20,7,0,13,30,4,2,6,2,13,15,7,15
22200730,False,NYK,15900,120,52,31,21,10,0,17,38,2,1,3,4,10,12,9,14
22200731,True,BKN,14400,122,48,37,11,20,0,6,15,5,1,6,0,12,10,2,12
22200731,False,DET,14400,130,45,28,17,13,0,10,23,9,4,13,1,2,3,1,3
22200732,True,CHA,14400,111,63,43,20,11,0,7,17,2,2,4,3,5,8,5,8
22200732,False,CHI,14400,96,51,29,22,15,3,11,23,5,3,8,0,5,5,3,5
22200733,True,HOU,14400,95,43,31,12,10,0,3,8,3,1,4,1,2,2,2,3
22200733,False,CLE,14400,113,33,23,10,22,1,8,19,1,6,7,0,6,5,2,6
22200734,True,PHX,14400,95,47,29,18,14,0,7,15,3,2,5,1,5,6,5,6
22200734,False,DAL,14400,99,45,35,10,8,0,7,19,4,1,5,0,5,5,2,5
22200735,True,LAC,14400,138,39,31,8,14,0,14,30,1,2,3,1,2,3,2,3
22200735,False,SAS,14400,100,29,17,12,11,0,7,15,2,1,3,1,0,1,1,1
22200736,True,IND,14400,131,58,30,28,17,0,15,31,3,7,10,3,7,8,3,10
22200736,False,MIL,14400,141,52,28,24,14,0,3,6,5,3,8,3,11,14,8,14
22200737,True,MIN,14400,111,50,32,18,19,0,4,9,2,3,5,2,5,7,2,7
22200737,False,MEM,14400,100,40,23,17,18,0,7,15,2,3,5,1,10,11,4,11
22200738,True,MIA,14400,110,35,21,14,13,2,8,18,3,3,6,0,4,4,3,4
22200738,False,ORL,14400,105,40,25,15,11,0,12,29,0,5,5,2,2,4,4,4
22200739,True,OKC,14400,112,41,28,13,10,2,1,2,1,2,3,2,2,4,3,4
22200739,False,CLE,14400,100,38,32,6,19,0,6,15,1,3,4,0,3,2,1,3
22200740,True,GSW,14400,129,53,36,17,17,0,10,24,2,5,7,1,2,3,2,3
22200740,False,TOR,14400,117,35,16,19,16,0,5,13,1,2,3,1,3,4,2,4
22200741,True,PHI,14400,126,36,24,12,14,0,5,12,1,3,4,3,4,7,5,7
22200741,False,DEN,14400,119,42,32,10,22,1,9,20,3,2,5,0,2,2,1,2
22200742,True,BKN,14400,122,37,24,13,11,0,12,28,3,3,6,0,4,3,1,4
22200742,False,NYK,14400,115,47,29,18,5,0,9,20,2,1,3,2,3,4,2,5
22200743,True,DET,14400,114,64,43,21,24,0,8,21,4,5,9,4,5,7,6,9
22200743,False,HOU,14400,117,51,25,26,21,2,2,4,4,1,5,1,9,9,5,10
22200744,True,ORL,14400,109,37,16,21,6,0,7,16,3,3,6,0,3,3,2,3
22200744,False,CHI,14400,128,53,30,23,11,0,6,14,1,2,3,3,4,7,3,7
22200745,True,ATL,14400,113,49,22,27,17,0,10,20,7,6,13,2,8,10,4,10
22200745,False,LAC,14400,120,58,37,21,11,0,12,27,6,4,10,1,13,12,3,14
22200746,True,MIN,14400,117,35,23,12,11,0,3,7,2,0,2,1,8,9,5,9
22200746,False,SAC,14400,110,40,25,15,11,1,12,27,1,1,2,1,1,2,1,2
22200747,True,NOP,14400,103,41,22,19,18,1,8,18,1,0,1,2,2,4,3,4
22200747,False,WAS,14400,113,35,23,12,7,1,5,12,2,0,2,2,1,3,2,3
22200748,True,SAS,15900,118,56,37,19,8,0,17,36,1,3,4,1,3,2,1,4
22200748,False,PHX,15900,128,48,28,20,11,0,24,51,1,0,1,1,4,5,2,5
22200749,True,BOS,15900,125,59,36,23,11,0,10,25,1,2,3,0,11,11,2,11
22200749,False,LAL,15900,121,36,17,19,11,2,7,17,1,1,2,0,4,4,2,4
22200750,True,UTA,14400,108,34,18,16,16,0,7,18,1,1,2,4,1,5,3,5
22200750,False,DAL,14400,100,49,25,24,9,0,7,16,3,1,4,0,4,4,0,4
22200751,True,POR,14400,105,39,25,14,11,2,12,26,1,0,1,0,5,5,2,5
22200751,False,TOR,14400,123,31,23,8,12,0,5,13,3,1,4,2,3,5,4,5
22200752,True,CHA,14400,122,36,24,12,16,1,6,14,0,2,2,1,5,5,3,6
22200752,False,MIA,14400,117,32,17,15,16,3,11,23,0,1,1,0,8,8,1,8
22200753,True,MEM,14400,112,50,30,20,14,0,4,9,2,2,4,0,4,1,0,4
22200753,False,IND,14400,100,59,35,24,7,1,5,10,4,1,5,1,10,3,2,11
22200754,True,CLE,14400,122,45,35,10,14,0,13,33,2,2,4,0,3,3,2,3
22200754,False,LAC,14400,99,35,19,16,13,0,12,24,0,1,1,4,1,5,3,5
22200755,True,MIL,14400,135,44,30,14,10,0,11,26,1,0,1,1,2,3,2,3
22200755,False,NOP,14400,110,35,17,18,13,0,11,26,1,4,5,0,3,3,1,3
22200756,True,PHI,14400,109,46,37,9,10,0,3,6,7,4,11,1,13,11,3,14
22200756,False,ORL,14400,119,50,28,22,19,0,8,18,1,6,7,2,3,5,2,5
22200757,True,BKN,14400,121,51,39,12,20,0,13,31,2,4,6,5,13,17,12,18
22200757,False,LAL,14400,104,38,20,18,9,0,4,9,5,4,9,6,4,10,7,10
22200758,True,MIN,15900,111,45,34,11,21,0,9,19,3,1,4,1,2,3,2,3
22200758,False,SAC,15900,118,55,30,25,18,0,10,23,5,2,7,1,9,8,2,10
22200759,True,OKC,14400,120,47,22,25,14,0,8,17,4,0,4,1,2,3,3,3
22200759,False,GSW,14400,128,53,39,14,16,2,12,33,1,1,2,1,2,3,2,3
22200760,True,SAS,14400,106,40,28,12,15,0,9,19,1,0,1,0,2,2,1,2
22200760,False,WAS,14400,127,42,33,9,17,0,6,14,2,0,2,1,5,6,4,6
22200761,True,DAL,14400,111,40,25,15,11,0,7,18,0,5,5,0,13,13,2,13
22200761,False,DET,14400,105,43,21,22,12,0,7,15,0,2,2,2,4,6,4,6
22200762,True,PHX,14400,114,51,31,20,19,0,6,13,1,3,4,3,4,7,5,7
22200762,False,TOR,14400,106,39,28,11,15,0,10,20,1,3,4,1,2,3,2,3
22200763,True,POR,14400,129,29,23,6,8,0,15,38,0,1,1,0,1,1,0,1
22200763,False,ATL,14400,125,25,17,8,7,0,7,16,1,1,2,1,0,1,1,1
22200764,True,CLE,14400,97,45,29,16,15,0,7,15,1,2,3,0,0,0,0,0
22200764,False,MIA,14400,100,28,9,19,13,0,4,10,1,0,1,1,3,4,1,4
22200765,True,NYK,15900,123,52,32,20,13,2,7,16,4,0,4,1,9,10,5,10
22200765,False,LAL,15900,129,45,29,16,14,0,13,28,5,3,8,1,3,4,3,4
22200766,True,CHI,14400,103,47,26,21,13,0,6,13,2,0,2,0,3,3,2,3
22200766,False,LAC,14400,108,41,30,11,16,0,6,14,1,3,4,2,5,7,4,7
22200767,True,MIL,14400,124,49,35,14,14,1,5,11,4,4,8,0,8,8,1,8
22200767,False,CHA,14400,115,40,21,19,9,0,10,21,4,1,5,1,4,5,3,5
22200768,True,DEN,14400,122,35,24,11,18,2,9,25,3,1,4,2,2,4,2,4
22200768,False,NOP,14400,113,44,22,22,20,1,10,20,1,2,3,1,2,3,1,3
22200769,True,DET,14400,117,40,25,15,9,1,4,10,2,2,4,1,4,4,2,5
22200769,False,WAS,14400,119,55,39,16,15,0,12,25,2,5,7,2,7,8,6,9
22200770,True,PHI,14400,105,39,26,13,7,1,4,9,2,3,5,0,11,11,6,11
22200770,False,ORL,14400,94,33,17,16,17,0,5,10,1,3,4,0,1,1,0,1
22200771,True,MEM,14400,112,43,27,16,18,0,7,16,2,2,4,1,6,5,1,7
22200771,False,POR,14400,122,36,20,16,11,0,13,34,2,2,4,1,8,7,4,9
22200772,True,BOS,14400,139,66,32,34,9,0,3,7,3,1,4,3,8,11,3,11
22200772,False,BKN,14400,96,48,13,35,11,0,9,20,3,3,6,2,9,9,4,11
22200773,True,HOU,14400,112,55,40,15,12,0,6,13,4,5,9,0,6,2,1,6
22200773,False,OKC,14400,106,48,37,11,17,3,1,3,5,2,7,2,4,5,4,6
22200774,True,MIN,15900,119,50,33,17,15,0,6,14,0,2,2,4,8,12,7,12
22200774,False,GSW,15900,114,63,39,24,15,1,8,19,2,2,4,1,5,5,1,6
22200775,True,SAS,14400,109,47,35,12,10,2,6,15,1,3,4,1,6,5,3,7
22200775,False,SAC,14400,119,69,53,16,12,0,11,23,2,5,7,0,3,3,2,3
22200776,True,UTA,14400,131,46,38,8,6,1,9,22,2,2,4,1,4,5,4,5
22200776,False,TOR,14400,128,23,10,13,13,0,8,19,2,4,6,0,2,2,1,2
22200777,True,PHX,14400,100,36,18,18,10,0,4,8,1,2,3,0,3,2,2,3
22200777,False,ATL,14400,132,30,21,9,13,0,17,37,2,0,2,0,5,4,2,5
22200778,True,IND,14400,111,47,36,11,16,1,10,25,0,4,4,2,5,7,4,7
22200778,False,LAL,14400,112,45,28,17,12,1,5,12,3,5,8,3,3,6,5,6
22200779,True,CLE,14400,128,54,37,17,19,2,14,33,4,5,9,2,9,10,6,11
22200779,False,MEM,14400,113,45,30,15,19,1,9,18,3,4,7,1,8,9,7,9
22200780,True,NYK,14400,106,49,31,18,10,0,2,4,3,3,6,0,2,2,0,2
22200780,False,MIA,14400,104,34,17,17,19,2,9,23,1,4,5,0,7,6,3,7
22200781,True,CHI,14400,114,36,21,15,12,0,8,16,1,4,5,2,0,2,1,2
22200781,False,CHA,14400,98,35,25,10,14,1,8,17,1,2,3,1,2,3,2,3
22200782,True,DAL,14400,111,35,30,5,10,1,13,29,1,2,3,0,5,5,0,5
22200782,False,NOP,14400,106,43,18,25,12,0,10,20,2,0,2,4,3,7,4,7
22200783,True,DEN,14400,134,34,19,15,11,0,11,24,1,4,5,0,3,3,2,3
22200783,False,GSW,14400,117,36,20,16,9,0,11,27,3,1,4,1,2,3,2,3
22200784,True,MIL,14400,106,54,35,19,16,1,7,16,1,1,2,1,1,2,2,2
22200784,False,LAC,14400,105,43,29,14,15,0,11,27,1,3,4,1,1,2,2,2
22200785,True,DET,14400,118,52,37,15,13,1,10,23,3,1,4,2,4,6,6,6
22200785,False,CHA,14400,112,41,26,15,20,0,6,13,3,5,8,2,2,4,4,4
22200786,True,IND,14400,107,46,32,14,19,1,1,3,2,5,7,0,5,5,4,5
22200786,False,SAC,14400,104,44,27,17,14,1,8,21,2,0,2,0,3,3,2,3
22200787,True,WAS,14400,116,38,21,17,13,0,7,17,2,1,3,1,0,1,1,1
22200787,False,POR,14400,124,54,28,26,12,1,13,35,2,3,5,0,4,1,1,4
22200788,True,BOS,14400,94,50,35,15,10,0,5,13,3,3,6,0,2,2,0,2
22200788,False,PHX,14400,106,41,19,22,11,0,13,27,2,1,3,3,2,5,5,5
22200789,True,HOU,14400,111,50,30,20,14,1,3,7,3,3,6,1,10,11,6,11
22200789,False,TOR,14400,117,45,33,12,21,0,10,24,3,3,6,0,6,6,1,6
22200790,True,MIN,14400,120,38,31,7,17,1,7,17,3,0,3,1,3,4,3,4
22200790,False,ORL,14400,127,24,16,8,13,1,8,19,3,4,7,1,1,2,2,2
22200791,True,SAS,14400,125,38,25,13,13,0,13,26,3,3,6,2,1,3,3,3
22200791,False,PHI,14400,137,34,24,10,10,0,7,16,5,4,9,1,4,5,3,5
22200792,True,UTA,14400,108,46,28,18,13,0,12,27,0,1,1,0,4,4,2,4
22200792,False,ATL,14400,115,44,22,22,14,0,15,35,2,4,6,2,3,5,4,5
22200793,True,BKN,14400,125,44,32,12,14,1,9,21,0,1,1,0,4,3,1,4
22200793,False,WAS,14400,123,33,25,8,11,0,9,21,2,4,6,1,0,1,1,1
22200794,True,DET,14400,100,43,30,13,14,0,8,19,4,1,5,3,5,8,5,8
22200794,False,PHX,14400,116,39,22,17,19,0,4,9,0,4,4,1,11,12,7,12
22200795,True,NYK,15900,128,40,25,15,10,1,11,25,0,7,7,1,5,6,1,6
22200795,False,LAC,15900,134,47,28,19,10,0,12,29,1,1,2,0,5,4,3,5
22200796,True,CHI,14400,129,32,15,17,13,1,14,32,1,2,3,1,2,3,3,3
22200796,False,POR,14400,121,35,24,11,10,1,16,37,0,2,2,0,2,2,0,2
22200797,True,MIL,14400,123,50,38,12,8,0,6,15,2,2,4,1,4,5,3,5
22200797,False,MIA,14400,115,32,15,17,16,0,18,37,0,5,5,0,7,5,1,7
22200798,True,NOP,14400,131,39,21,18,11,1,14,29,5,3,8,2,3,5,3,5
22200798,False,LAL,14400,126,37,28,9,10,1,4,9,4,1,5,2,1,3,3,3
22200799,True,OKC,14400,153,52,34,18,21,2,11,28,3,3,6,1,5,6,2,6
22200799,False,HOU,14400,121,48,28,20,13,0,14,31,2,1,3,3,0,3,2,3
22200800,True,GSW,14400,119,42,23,19,12,1,10,26,0,2,2,2,0,2,2,2
22200800,False,DAL,14400,113,35,20,15,16,0,6,16,0,2,2,0,0,0,0,0
22200801,True,DEN,14400,128,51,40,11,20,0,7,16,3,0,3,1,4,5,2,5
22200801,False,ATL,14400,108,39,24,15,10,0,10,22,2,1,3,0,1,1,1,1
22200802,True,CHA,14400,113,31,26,5,11,0,7,15,0,2,2,0,1,1,0,1
22200802,False,ORL,14400,119,44,24,20,10,1,8,17,3,2,5,1,3,4,1,4
22200803,True,IND,14400,103,34,20,14,11,2,4,8,0,2,2,0,2,2,0,2
22200803,False,CLE,14400,122,53,37,16,10,1,7,16,1,2,3,0,7,7,3,7
22200804,True,NYK,14400,108,37,27,10,10,0,6,14,4,1,5,1,6,6,4,7
22200804,False,PHI,14400,97,34,16,18,11,0,3,6,4,1,5,0,6,4,3,6
22200805,True,MEM,14400,103,67,46,21,16,0,9,20,1,4,5,0,5,5,4,5
22200805,False,TOR,14400,106,39,23,16,20,1,5,12,1,3,4,0,5,4,2,5
22200806,True,MIN,14400,128,41,27,14,12,0,5,13,0,1,1,1,1,2,1,2
22200806,False,DEN,14400,98,40,27,13,10,0,6,12,1,1,2,1,2,3,2,3
22200807,True,NOP,14400,136,25,17,8,21,0,8,18,1,0,1,1,7,8,3,8
22200807,False,SAC,14400,104,35,25,10,12,0,7,16,8,1,9,0,3,3,1,3
22200808,True,DET,14400,99,43,17,26,11,0,14,31,6,2,8,3,3,6,3,6
22200808,False,BOS,14400,111,49,26,23,11,1,10,24,2,5,7,5,15,18,10,20
22200809,True,WAS,14400,91,34,23,11,13,1,5,11,1,2,3,0,1,1,1,1
22200809,False,CLE,14400,114,53,39,14,15,0,3,7,2,3,5,0,3,3,2,3
22200810,True,BKN,14400,116,49,31,18,14,0,14,34,1,2,3,0,4,4,0,4
22200810,False,LAC,14400,124,45,29,16,11,1,12,28,4,6,10,3,9,11,6,12
22200811,True,CHI,14400,128,45,31,14,13,3,10,20,0,1,1,1,4,5,5,5
22200811,False,SAS,14400,104,36,30,6,10,0,7,14,1,2,3,0,4,4,0,4
22200812,True,HOU,14400,120,41,28,13,13,0,8,19,1,1,2,0,3,3,0,3
22200812,False,SAC,14400,140,42,28,14,14,1,17,44,3,1,4,0,3,3,2,3
22200813,True,UTA,14400,111,45,25,20,12,1,12,30,2,2,4,1,4,5,1,5
22200813,False,DAL,14400,124,41,28,13,8,2,6,14,4,4,8,1,10,11,3,11
22200814,True,GSW,14400,141,42,29,13,8,0,16,42,1,1,2,4,5,9,8,9
22200814,False,OKC,14400,114,51,24,27,17,1,7,16,1,0,1,0,4,4,1,4
22200815,True,POR,14400,108,44,23,21,7,1,7,16,1,1,2,0,4,3,0,4
22200815,False,MIL,14400,127,43,31,12,11,0,11,23,1,0,1,0,5,5,1,5
22200816,True,ORL,14400,98,41,16,25,13,1,8,16,2,2,4,1,4,4,2,5
22200816,False,NYK,14400,102,45,30,15,6,0,4,10,1,4,5,0,5,4,1,5
22200817,True,BKN,14400,112,42,27,15,16,0,9,19,3,6,9,1,10,7,3,11
22200817,False,PHX,14400,116,45,31,14,13,0,6,13,2,3,5,1,7,5,2,8
22200818,True,NOP,14400,116,38,20,18,18,0,11,24,3,1,4,0,3,3,0,3
22200818,False,ATL,14400,107,32,20,12,11,0,8,19,2,1,3,0,3,1,0,3
22200819,True,MEM,14400,104,40,21,19,20,0,5,11,1,2,3,0,4,4,2,4
22200819,False,CHI,14400,89,41,26,15,17,1,7,14,3,1,4,3,11,12,3,14
22200820,True,DEN,14400,146,28,22,6,15,0,6,13,0,1,1,0,6,6,3,6
22200820,False,MIN,14400,112,38,28,10,10,1,4,9,2,2,4,1,0,1,1,1
22200821,True,LAL,14400,130,46,32,14,16,0,8,19,3,4,7,1,4,5,2,5
22200821,False,OKC,14400,133,38,24,14,21,2,6,13,6,6,12,0,9,8,4,9
22200822,True,CLE,14400,113,61,37,24,16,0,6,12,3,2,5,1,3,2,1,4
22200822,False,DET,14400,85,55,41,14,14,0,4,9,2,0,2,0,1,0,0,1
22200823,True,WAS,14400,118,36,24,12,9,1,7,16,4,1,5,2,4,4,1,6
22200823,False,CHA,14400,104,33,18,15,28,0,9,20,2,3,5,1,0,0,0,1
22200824,True,BOS,14400,106,50,32,18,14,1,10,23,5,1,6,1,6,7,4,7
22200824,False,PHI,14400,99,37,18,19,22,0,5,10,4,2,6,2,6,7,1,8
22200825,True,MIA,14400,116,30,17,13,13,0,6,13,2,0,2,1,1,2,1,2
22200825,False,IND,14400,111,31,22,9,13,0,5,12,1,0,1,0,1,1,0,1
22200826,True,TOR,14400,112,52,33,19,30,0,8,17,2,5,7,0,7,6,2,7
22200826,False,SAS,14400,98,62,45,17,12,0,7,16,3,3,6,0,10,7,2,10
22200827,True,HOU,14400,128,52,39,13,11,0,6,15,2,3,5,1,7,8,4,8
22200827,False,SAC,14400,130,45,35,10,21,1,10,24,0,2,2,1,1,2,1,2
22200828,True,UTA,14400,118,57,29,28,8,1,7,18,3,1,4,1,1,2,1,2
22200828,False,MIN,14400,143,50,34,16,19,0,15,36,4,1,5,0,10,9,5,10
22200829,True,LAC,14400,104,42,23,19,21,0,13,28,3,6,9,1,6,7,5,7
22200829,False,DAL,14400,110,48,35,13,10,1,5,12,1,6,7,1,9,10,4,10
22200830,True,POR,14400,125,43,16,27,3,0,7,17,1,0,1,0,8,8,4,8
22200830,False,GSW,14400,122,34,20,14,20,1,10,28,1,1,2,0,1,1,1,1
22200831,True,ORL,14400,115,42,27,15,7,0,4,8,1,2,3,1,2,2,1,3
22200831,False,DEN,14400,104,41,36,5,11,0,5,12,1,5,6,0,3,3,2,3
22200832,True,ATL,14400,116,36,24,12,10,0,8,17,2,0,2,0,3,3,1,3
22200832,False,PHX,14400,107,43,27,16,17,0,7,15,1,2,3,0,0,0,0,0
22200833,True,BKN,14400,116,37,30,7,9,0,5,12,2,1,3,0,2,2,0,2
22200833,False,CHI,14400,105,46,26,20,7,0,5,10,0,0,0,1,2,3,0,3
22200834,True,LAL,14400,106,50,27,23,10,3,14,30,2,0,2,3,2,5,4,5
22200834,False,MIL,14400,115,54,46,8,6,0,11,24,2,3,5,7,3,9,6,10
22200835,True,DET,17400,138,64,44,20,10,0,12,24,4,4,8,0,11,11,4,11
22200835,False,SAS,17400,131,57,35,22,9,1,10,25,5,2,7,0,9,9,4,9
22200836,True,IND,14400,104,40,27,13,20,1,10,24,2,1,3,2,3,5,2,5
22200836,False,PHX,14400,117,40,26,14,18,0,7,16,3,4,7,3,6,9,6,9
22200837,True,PHI,14400,119,44,25,19,12,0,7,16,0,3,3,2,14,14,11,16
22200837,False,NYK,14400,108,55,27,28,1,1,9,20,1,1,2,2,4,5,5,6
22200838,True,BOS,14400,127,36,31,5,8,1,13,32,0,0,0,0,4,4,2,4
22200838,False,CHA,14400,116,32,15,17,14,0,12,27,3,1,4,0,1,1,0,1
22200839,True,TOR,14400,116,45,31,14,19,0,9,21,3,2,5,1,5,6,4,6
22200839,False,UTA,14400,122,54,36,18,10,0,13,26,2,3,5,0,5,5,3,5
22200840,True,MIA,14400,97,34,18,16,25,0,8,18,1,0,1,0,3,3,1,3
22200840,False,HOU,14400,95,38,18,20,13,1,3,6,3,0,3,0,3,3,1,3
22200841,True,MEM,14400,128,40,28,12,19,0,14,32,4,2,6,0,0,0,0,0
22200841,False,MIN,14400,107,31,20,11,10,2,4,9,1,1,2,0,2,2,2,2
22200842,True,NOP,14400,107,29,22,7,20,0,3,6,2,3,5,1,5,6,3,6
22200842,False,CLE,14400,118,32,24,8,17,0,6,14,5,3,8,0,3,3,1,3
22200843,True,POR,14400,129,28,23,5,12,1,7,18,1,3,4,1,2,3,2,3
22200843,False,OKC,14400,138,37,16,21,14,1,7,15,0,4,4,0,4,4,0,4
22200844,True,SAC,14400,114,54,28,26,13,0,10,22,0,1,1,1,3,4,3,4
22200844,False,DAL,14400,122,35,22,13,9,1,7,15,3,0,3,1,3,4,4,4
22200845,True,LAC,14400,106,41,27,14,15,0,19,41,1,1,2,0,3,3,0,3
22200845,False,MIL,14400,119,43,27,16,17,0,7,15,5,1,6,0,7,7,2,7
22200846,True,BKN,14400,98,43,30,13,19,0,10,24,2,0,2,0,4,3,1,4
22200846,False,PHI,14400,101,42,23,19,6,0,0,0,1,3,4,2,4,6,4,6
22200847,True,CHA,14400,105,55,40,15,13,0,11,24,1,7,8,2,6,7,4,8
22200847,False,DEN,14400,119,49,26,23,12,0,11,22,4,0,4,1,11,12,4,12
22200848,True,ORL,15900,103,44,26,18,23,1,5,11,0,2,2,3,4,7,4,7
22200848,False,MIA,15900,107,51,37,14,17,4,7,17,0,2,2,1,6,6,2,7
22200849,True,WAS,14400,127,42,27,15,10,0,12,27,1,1,2,0,7,7,2,7
22200849,False,IND,14400,113,35,20,15,20,0,5,11,2,2,4,3,4,7,4,7
22200850,True,ATL,14400,125,45,30,15,14,1,11,24,1,3,4,0,2,2,1,2
22200850,False,SAS,14400,106,53,43,10,10,0,8,17,1,0,1,0,3,3,0,3
22200851,True,NYK,14400,126,50,32,18,8,0,15,33,6,1,7,2,7,9,7,9
22200851,False,UTA,14400,120,61,42,19,6,1,15,32,2,1,3,0,5,5,2,5
22200852,True,CLE,14400,97,34,26,8,18,2,7,18,2,4,6,0,1,1,0,1
22200852,False,CHI,14400,89,38,28,10,10,0,4,9,4,3,7,1,2,3,1,3
22200853,True,GSW,14400,103,51,37,14,22,1,12,29,3,1,4,1,3,4,3,4
22200853,False,LAL,14400,109,50,24,26,10,0,13,27,4,0,4,0,3,3,2,3
22200854,True,SAC,15900,133,46,19,27,16,0,14,31,0,1,1,1,1,2,2,2
22200854,False,DAL,15900,128,40,29,11,11,0,7,16,2,1,3,2,1,3,2,3
22200855,True,BOS,14400,119,44,25,19,9,0,7,18,4,0,4,3,8,11,10,11
22200855,False,MEM,14400,109,43,19,24,11,0,10,22,1,3,4,1,8,8,4,9
22200856,True,TOR,14400,119,41,26,15,21,0,8,21,3,3,6,0,7,7,4,7
22200856,False,DET,14400,118,49,36,13,9,0,6,12,3,3,6,0,4,4,2,4
22200857,True,CHA,14400,144,43,35,8,9,0,14,31,1,2,3,0,2,2,0,2
22200857,False,ATL,14400,138,39,21,18,12,0,15,32,3,1,4,0,1,1,0,1
22200858,True,CLE,14400,117,40,36,4,15,0,12,25,3,0,3,0,0,0,0,0
22200858,False,SAS,14400,109,33,25,8,16,0,8,18,1,0,1,2,0,2,1,2
22200859,True,IND,14400,117,45,26,19,17,0,15,32,2,6,8,0,7,6,3,7
22200859,False,UTA,14400,123,38,24,14,12,0,12,31,3,1,4,0,0,0,0,0
22200860,True,PHI,14400,123,42,29,13,20,0,11,27,3,2,5,0,4,4,2,4
22200860,False,HOU,14400,104,46,24,22,15,2,6,15,3,3,6,2,0,2,2,2
22200861,True,MIA,14400,108,27,14,13,9,0,6,16,1,2,3,0,3,3,1,3
22200861,False,DEN,14400,112,36,20,16,8,1,6,13,2,0,2,0,0,0,0,0
22200862,True,NYK,14400,124,43,27,16,14,1,5,12,1,1,2,0,10,10,5,10
22200862,False,BKN,14400,106,49,27,22,11,0,8,21,3,2,5,1,5,6,2,6
22200863,True,CHI,14400,91,37,26,11,15,0,5,10,2,2,4,1,1,2,2,2
22200863,False,ORL,14400,100,50,38,12,16,3,6,14,2,2,4,1,2,3,2,3
22200864,True,OKC,14400,100,45,30,15,13,4,1,2,2,3,5,1,1,2,1,2
22200864,False,NOP,14400,103,48,30,18,20,0,12,26,2,2,4,0,1,1,0,1
22200865,True,DAL,14400,121,29,18,11,10,0,7,15,2,0,2,1,1,2,2,2
22200865,False,MIN,14400,124,25,13,12,17,0,5,10,1,4,5,2,4,6,5,6
22200866,True,GSW,14400,135,43,26,17,14,1,16,42,4,3,7,4,6,10,6,10
22200866,False,WAS,14400,126,50,30,20,14,1,8,17,1,0,1,1,7,7,4,8
22200867,True,POR,14400,127,50,29,21,16,1,13,32,0,1,1,0,3,3,1,3
22200867,False,LAL,14400,115,53,29,24,12,0,6,15,1,2,3,2,3,5,5,5
22200868,True,TOR,14400,123,51,30,21,14,0,6,15,3,3,6,1,2,2,2,3
22200868,False,ORL,14400,113,31,21,10,12,0,4,10,1,3,4,1,6,5,3,7
22200869,True,MIL,15900,131,42,19,23,16,0,6,15,3,3,6,0,4,4,1,4
22200869,False,BOS,15900,125,35,19,16,13,2,19,46,3,2,5,2,8,10,7,10
22200870,True,PHX,14400,120,46,26,20,19,0,12,24,1,3,4,0,1,1,0,1
22200870,False,SAC,14400,109,45,34,11,16,0,11,24,0,1,1,1,2,3,2,3
22200871,True,LAC,14400,134,37,23,14,10,0,12,27,1,3,4,2,6,8,4,8
22200871,False,GSW,14400,124,65,43,22,11,0,14,33,2,2,4,3,6,4,2,9
22200872,True,POR,14400,101,38,22,16,18,0,3,6,2,4,6,1,4,5,1,5
22200872,False,WAS,14400,126,30,20,10,18,0,6,14,1,1,2,0,4,4,2,4
22200873,True,CHA,14400,120,60,42,18,21,1,10,21,2,8,10,2,5,7,5,7
22200873,False,SAS,14400,110,56,33,23,12,0,11,26,2,1,3,0,1,1,1,1
22200874,True,IND,14400,117,56,34,22,13,1,8,19,0,2,2,0,3,1,0,3
22200874,False,CHI,14400,113,49,22,27,15,0,5,10,2,0,2,1,5,2,0,6
22200875,True,PHI,14400,118,32,17,15,13,0,6,16,3,2,5,3,9,10,3,12
22200875,False,CLE,14400,112,50,40,10,14,0,12,27,8,4,12,1,5,4,3,6
22200876,True,ATL,14400,101,51,28,23,9,0,8,17,1,3,4,0,2,2,0,2
22200876,False,NYK,14400,122,54,38,16,7,0,10,24,1,5,6,3,3,6,5,6
22200877,True,BOS,14400,127,36,26,10,11,0,8,21,0,4,4,1,6,7,2,7
22200877,False,DET,14400,109,47,25,22,11,0,9,19,1,0,1,0,2,2,1,2
22200878,True,BKN,14400,116,34,18,16,9,0,12,29,1,1,2,0,4,4,2,4
22200878,False,MIA,14400,105,28,13,15,10,0,9,20,2,1,3,0,3,3,0,3
22200879,True,MEM,14400,117,41,29,12,15,0,10,22,6,2,8,0,2,2,0,2
22200879,False,UTA,14400,111,62,46,16,15,0,7,15,2,0,2,0,3,3,1,3
22200880,True,OKC,14400,133,54,32,22,12,4,4,9,0,0,0,3,7,10,7,10
22200880,False,HOU,14400,96,47,31,16,8,0,4,10,4,2,6,2,3,5,4,5
22200881,True,DEN,14400,118,42,23,19,14,0,9,19,2,0,2,1,2,1,1,3
22200881,False,DAL,14400,109,37,22,15,11,0,10,24,0,0,0,1,3,3,1,4
22200882,True,LAL,14400,120,46,37,9,14,1,4,10,0,2,2,2,7,9,6,9
22200882,False,NOP,14400,102,33,17,16,8,1,9,18,3,3,6,2,5,7,5,7
22200883,True,CHI,14400,100,50,23,27,14,1,8,16,4,3,7,1,3,4,2,4
22200883,False,MIL,14400,112,56,41,15,5,0,11,27,3,1,4,2,4,6,5,6
22200884,True,MIN,14400,106,45,29,16,14,0,7,14,2,1,3,1,2,3,2,3
22200884,False,WAS,14400,114,43,32,11,15,0,9,21,2,3,5,0,2,2,1,2
22200885,True,PHX,14400,107,37,25,12,11,0,9,18,0,1,1,0,5,5,3,5
22200885,False,LAC,14400,116,32,21,11,11,0,9,19,3,6,9,1,4,4,0,5
22200886,True,CLE,14400,109,48,27,21,18,0,6,13,2,1,3,0,7,7,4,7
22200886,False,DEN,14400,115,45,33,12,16,0,6,14,5,3,8,1,3,4,3,4
22200887,True,IND,15900,138,48,31,17,13,1,7,16,1,0,1,4,0,4,4,4
22200887,False,BOS,15900,142,44,23,21,7,0,9,23,5,2,7,1,0,1,1,1
22200888,True,ORL,14400,108,49,29,20,17,0,5,10,3,3,6,0,5,5,0,5
22200888,False,DET,14400,106,45,31,14,13,1,11,27,3,2,5,0,4,4,2,4
22200889,True,PHI,14400,110,42,29,13,7,1,5,11,5,3,8,0,9,9,5,9
22200889,False,MEM,14400,105,58,34,24,18,2,12,25,8,0,8,2,3,5,3,5
22200890,True,TOR,14400,115,44,29,15,15,0,8,17,2,1,3,0,9,9,3,9
22200890,False,NOP,14400,110,52,33,19,13,2,8,16,0,2,2,0,12,12,6,12
22200891,True,DAL,14400,142,39,29,10,21,0,6,15,1,2,3,0,3,3,2,3
22200891,False,SAS,14400,116,38,20,18,10,0,10,24,2,3,5,0,3,3,0,3
22200892,True,UTA,15900,120,43,34,9,13,0,12,29,3,1,4,2,6,5,3,8
22200892,False,OKC,15900,119,46,25,21,22,2,7,14,3,3,6,1,16,9,3,17
22200893,True,LAL,14400,124,33,19,14,14,0,7,16,2,1,3,1,4,5,5,5
22200893,False,GSW,14400,111,45,26,19,17,0,7,19,3,2,5,5,6,11,7,11
22200894,True,SAC,14400,133,53,33,20,13,1,9,20,4,2,6,0,2,2,2,2
22200894,False,POR,14400,116,40,26,14,15,1,7,19,0,2,2,0,6,6,3,6
22200895,True,WAS,14400,109,47,36,11,8,1,12,26,1,1,2,0,7,7,2,7
22200895,False,NYK,14400,115,45,18,27,12,1,9,19,2,4,6,1,6,6,3,7
22200896,True,ATL,14400,136,35,22,13,12,0,14,35,2,1,3,0,3,3,1,3
22200896,False,CLE,14400,119,34,26,8,13,0,12,28,3,3,6,0,3,2,1,3
22200897,True,MIL,14400,128,40,28,12,5,0,10,25,1,2,3,1,1,2,2,2
22200897,False,MIA,14400,99,40,18,22,18,2,13,32,1,1,2,0,4,3,1,4
22200898,True,MIN,14400,113,50,37,13,9,0,7,15,2,1,3,0,2,2,0,2
22200898,False,CHA,14400,121,44,29,15,11,0,5,11,2,0,2,0,8,8,3,8
22200899,True,PHX,14400,124,42,26,16,8,1,13,30,4,2,6,1,8,7,3,9
22200899,False,OKC,14400,115,39,24,15,14,0,13,29,1,2,3,1,6,4,1,7
22200900,True,CHI,14400,131,52,22,30,7,0,10,24,0,5,5,1,6,6,4,7
22200900,False,BKN,14400,87,58,42,16,4,0,6,15,1,3,4,0,4,3,1,4
22200901,True,GSW,14400,116,57,35,22,10,1,12,34,1,1,2,1,4,5,3,5
22200901,False,HOU,14400,101,45,15,30,17,0,6,15,2,2,4,1,6,7,1,7
22200902,True,LAC,17400,175,51,27,24,18,1,4,9,3,4,7,1,5,6,3,6
22200902,False,SAC,17400,176,53,28,25,21,0,6,15,0,3,3,0,5,5,1,5
22200903,True,DET,14400,91,51,36,15,6,1,1,2,2,1,3,0,9,9,5,9
22200903,False,TOR,14400,95,60,47,13,18,0,3,6,1,1,2,1,9,10,7,10
22200904,True,CHA,14400,108,39,18,21,15,0,12,30,4,4,8,0,1,1,0,1
22200904,False,MIA,14400,103,44,34,10,15,0,6,12,2,3,5,1,4,5,2,5
22200905,True,ORL,14400,108,50,29,21,9,0,7,17,0,2,2,3,1,4,3,4
22200905,False,IND,14400,121,48,26,22,19,0,2,5,2,0,2,0,0,0,0,0
22200906,True,NYK,14400,128,53,36,17,4,0,7,17,2,1,3,3,7,9,5,10
22200906,False,NOP,14400,106,33,17,16,17,0,8,17,0,5,5,2,6,7,4,8
22200907,True,MEM,14400,112,41,27,14,18,0,4,9,2,3,5,3,3,6,4,6
22200907,False,DEN,14400,94,50,21,29,7,0,8,19,3,0,3,3,0,3,2,3
22200908,True,PHI,14400,107,31,19,12,10,0,3,7,3,3,6,0,0,0,0,0
22200908,False,BOS,14400,110,42,27,15,10,0,13,31,1,0,1,1,2,3,3,3
22200909,True,UTA,14400,118,67,43,24,11,0,9,20,3,1,4,1,4,5,4,5
22200909,False,SAS,14400,102,51,33,18,22,1,7,16,4,3,7,0,3,3,2,3
22200910,True,MIL,14400,104,55,44,11,16,1,8,20,5,3,8,3,7,9,4,10
22200910,False,PHX,14400,101,50,25,25,10,1,17,35,4,4,8,2,4,6,4,6
22200911,True,ATL,14400,129,40,21,19,9,1,8,19,2,2,4,3,0,3,3,3
22200911,False,BKN,14400,127,45,32,13,18,0,4,8,2,1,3,1,4,5,3,5
22200912,True,CHI,14400,102,43,26,17,19,3,12,24,3,2,5,2,2,4,3,4
22200912,False,WAS,14400,82,52,37,15,11,0,5,10,6,1,7,1,4,4,3,5
22200913,True,DAL,14400,108,40,22,18,10,1,9,23,2,1,3,3,9,12,8,12
22200913,False,LAL,14400,111,41,18,23,16,0,3,6,3,3,6,2,3,4,2,5
22200914,True,CLE,14400,118,48,30,18,13,1,8,21,0,1,1,0,2,2,1,2
22200914,False,TOR,14400,93,40,26,14,6,0,5,10,1,3,4,1,3,4,2,4
22200915,True,OKC,14400,115,49,22,27,16,2,7,16,3,3,6,0,6,6,1,6
22200915,False,SAC,14400,124,47,25,22,13,2,10,23,0,1,1,2,5,7,4,7
22200916,True,GSW,14400,109,67,35,32,14,0,11,30,4,1,5,5,7,12,8,12
22200916,False,MIN,14400,104,43,25,18,20,0,5,13,3,4,7,3,1,4,2,4
22200917,True,POR,14400,131,34,30,4,19,0,15,38,1,4,5,0,9,9,3,9
22200917,False,HOU,14400,114,40,19,21,10,3,6,12,1,1,2,1,1,2,1,2
22200918,True,DEN,15900,134,38,24,14,8,0,8,17,1,1,2,1,4,5,3,5
22200918,False,LAC,15900,124,50,27,23,17,0,9,22,0,1,1,1,3,4,3,4
22200919,True,CHA,14400,117,64,44,20,10,0,13,32,0,2,2,0,6,6,5,6
22200919,False,DET,14400,106,56,40,16,15,0,9,19,2,4,6,0,3,3,2,3
22200920,True,PHI,14400,99,43,21,22,7,0,6,13,6,5,11,2,14,14,9,16
22200920,False,MIA,14400,101,37,26,11,20,2,7,17,1,5,6,4,4,6,5,8
22200921,True,NYK,14400,109,55,31,24,9,0,10,23,5,1,6,6,5,9,5,11
22200921,False,BOS,14400,94,52,30,22,17,0,10,22,0,6,6,1,8,7,4,9
22200922,True,NOP,14400,93,38,21,17,17,1,6,12,0,5,5,1,5,6,2,6
22200922,False,ORL,14400,101,42,29,13,13,2,3,8,2,3,5,1,1,2,2,2
22200923,True,ATL,14400,116,56,44,12,8,0,11,23,1,3,4,0,3,3,2,3
22200923,False,WAS,14400,119,51,35,16,7,0,13,28,4,2,6,1,10,11,4,11
22200924,True,BKN,14400,104,47,32,15,14,0,11,24,0,2,2,0,3,3,1,3
22200924,False,MIL,14400,118,34,25,9,11,0,9,19,1,3,4,2,3,5,3,5
22200925,True,TOR,14400,104,43,30,13,14,1,6,16,4,6,10,1,3,4,2,4
22200925,False,CHI,14400,98,62,35,27,10,1,9,19,2,1,3,1,4,4,1,5
22200926,True,HOU,14400,112,46,20,26,15,1,13,31,2,2,4,0,3,3,1,3
22200926,False,DEN,14400,133,49,32,17,19,0,9,20,1,2,3,0,5,5,2,5
22200927,True,MEM,14400,121,47,30,17,23,0,12,25,0,3,3,2,3,4,1,5
22200927,False,LAL,14400,109,58,43,15,9,0,7,17,1,3,4,2,1,3,2,3
22200928,True,OKC,14400,117,59,28,31,13,1,6,13,1,2,3,1,3,2,1,4
22200928,False,SAC,14400,123,72,49,23,10,2,5,14,4,1,5,0,4,4,2,4
22200929,True,DAL,14400,122,42,28,14,11,0,9,21,4,1,5,0,5,5,1,5
22200929,False,IND,14400,124,54,29,25,4,0,6,12,2,2,4,0,4,3,3,4
22200930,True,UTA,14400,94,42,29,13,20,0,11,26,0,0,0,1,1,2,0,2
22200930,False,SAS,14400,102,39,26,13,16,0,17,36,2,0,2,0,1,1,0,1
22200931,True,GSW,14400,123,54,31,23,6,0,13,35,1,0,1,0,3,3,0,3
22200931,False,POR,14400,105,36,24,12,18,0,4,9,2,0,2,0,7,7,2,7
22200932,True,LAC,14400,101,36,27,9,14,2,11,26,1,5,6,1,5,3,2,6
22200932,False,MIN,14400,108,36,27,9,17,0,11,24,1,1,2,2,6,7,6,8
22200933,True,CHA,14400,91,51,40,11,15,0,7,16,5,2,7,0,3,3,2,3
22200933,False,PHX,14400,105,53,32,21,18,0,15,31,5,2,7,1,11,11,4,12
22200934,True,DET,14400,115,46,35,11,14,0,12,31,2,2,4,1,4,5,2,5
22200934,False,CHI,14400,117,44,23,21,17,0,5,11,4,4,8,1,6,7,2,7
22200935,True,BOS,14400,117,40,23,17,8,0,7,18,4,3,7,0,1,1,0,1
22200935,False,CLE,14400,113,33,20,13,10,0,14,32,3,3,6,0,2,2,0,2
22200936,True,MIA,14400,96,27,13,14,10,2,5,12,1,0,1,0,2,2,2,2
22200936,False,PHI,14400,119,36,18,18,11,0,5,14,0,1,1,0,2,2,0,2
22200937,True,NYK,14400,142,42,26,16,6,1,5,13,2,1,3,1,0,1,1,1
22200937,False,BKN,14400,118,41,20,21,9,0,10,22,1,1,2,0,2,2,0,2
22200938,True,HOU,14400,99,37,24,13,10,1,5,13,1,4,5,1,2,3,1,3
22200938,False,MEM,14400,113,43,34,9,20,1,9,23,0,1,1,1,3,4,3,4
22200939,True,MIL,14400,139,55,35,20,11,1,12,28,2,1,3,2,11,10,8,13
22200939,False,ORL,14400,117,63,22,41,8,0,9,18,4,1,5,1,5,3,2,6
22200940,True,OKC,14400,117,50,25,25,12,3,4,8,1,2,3,0,1,1,0,1
22200940,False,LAL,14400,123,38,22,16,13,1,10,22,2,4,6,2,2,4,3,4
22200941,True,POR,14400,110,35,26,9,10,0,12,27,0,1,1,3,1,4,3,4
22200941,False,NOP,14400,121,42,24,18,19,2,17,37,3,0,3,1,2,3,3,3
22200942,True,WAS,14400,119,48,27,21,14,1,5,12,1,2,3,3,9,10,3,12
22200942,False,TOR,14400,108,45,27,18,14,0,7,15,3,4,7,7,7,12,7,14
22200943,True,DAL,14400,133,39,28,11,10,0,9,23,0,3,3,0,7,7,3,7
22200943,False,PHI,14400,126,47,19,28,15,1,10,22,0,0,0,1,6,7,5,7
22200944,True,SAS,14400,110,44,35,9,8,2,10,21,3,0,3,2,5,7,4,7
22200944,False,IND,14400,99,62,42,20,15,1,12,25,0,4,4,0,2,2,1,2
22200945,True,GSW,14400,115,48,26,22,16,1,10,27,3,3,6,1,3,4,1,4
22200945,False,LAC,14400,91,46,20,26,17,1,7,16,2,3,5,1,4,5,3,5
22200946,True,CHA,14400,106,56,36,20,17,0,6,14,2,3,5,1,4,5,5,5
22200946,False,ORL,14400,117,39,25,14,21,1,10,22,3,3,6,2,7,9,5,9
22200947,True,ATL,14400,129,54,29,25,15,0,17,40,2,4,6,0,4,4,1,4
22200947,False,POR,14400,111,49,31,18,20,1,8,21,2,5,7,2,8,9,4,10
22200948,True,BOS,14400,105,46,23,23,14,0,5,10,3,3,6,0,1,1,0,1
22200948,False,BKN,14400,115,42,27,15,13,1,3,7,6,3,9,1,3,3,1,4
22200949,True,MIA,14400,120,41,18,23,21,1,8,18,0,2,2,4,3,7,4,7
22200949,False,NYK,14400,122,43,33,10,14,0,8,19,3,4,7,1,2,3,1,3
22200950,True,CHI,14400,104,42,19,23,11,0,14,29,3,4,7,0,4,4,2,4
22200950,False,PHX,14400,125,47,36,11,15,0,11,26,5,0,5,5,1,6,3,6
22200951,True,OKC,14400,130,31,23,8,17,1,11,26,5,1,6,1,2,3,3,3
22200951,False,UTA,14400,103,50,29,21,12,1,7,14,2,1,3,0,2,2,1,2
22200952,True,DEN,14400,113,37,23,14,10,0,9,20,0,2,2,1,9,7,4,10
22200952,False,MEM,14400,97,50,35,15,7,0,7,17,3,2,5,0,5,2,1,5
22200953,True,GSW,14400,108,38,27,11,10,0,6,14,2,0,2,0,6,6,3,6
22200953,False,NOP,14400,99,42,20,22,17,0,6,14,0,1,1,0,3,3,0,3
22200954,True,SAC,14400,128,44,27,17,10,1,8,17,4,0,4,2,1,3,2,3
22200954,False,LAC,14400,127,43,26,17,19,0,3,6,0,3,3,0,1,1,1,1
22200955,True,LAL,14400,102,37,24,13,12,0,6,12,3,4,7,1,5,6,3,6
22200955,False,MIN,14400,110,38,29,9,23,0,8,19,2,2,4,0,2,2,2,2
22200956,True,WAS,15900,109,47,30,17,13,0,7,16,2,2,4,0,4,4,2,4
22200956,False,TOR,15900,116,53,36,17,18,2,8,18,2,3,5,1,0,1,1,1
22200957,True,CLE,14400,114,43,31,12,23,2,10,23,1,3,4,0,5,5,2,5
22200957,False,DET,14400,90,41,32,9,9,0,4,8,4,2,6,0,1,1,0,1
22200958,True,MIA,14400,117,28,19,9,11,3,6,12,1,0,1,2,8,9,1,10
22200958,False,ATL,14400,109,36,24,12,20,1,6,13,1,2,3,0,0,0,0,0
22200959,True,SAS,14400,110,34,27,7,8,3,5,12,2,2,4,2,3,5,4,5
22200959,False,HOU,14400,122,41,22,19,12,0,9,18,0,2,2,0,0,0,0,0
22200960,True,MIL,14400,130,38,24,14,10,0,4,10,2,2,4,0,1,1,1,1
22200960,False,PHI,14400,133,39,26,13,12,1,13,34,1,0,1,0,2,2,1,2
22200961,True,SAC,14400,134,33,14,19,11,0,10,24,2,1,3,2,4,6,4,6
22200961,False,MIN,14400,138,49,36,13,10,0,6,13,3,1,4,1,2,3,3,3
22200962,True,DAL,14400,126,56,36,20,6,0,12,30,2,4,6,0,2,2,1,2
22200962,False,PHX,14400,130,33,14,19,10,1,7,17,1,2,3,1,2,3,1,3
22200963,True,CHI,14400,122,39,17,22,15,0,9,21,2,0,2,0,3,3,2,3
22200963,False,IND,14400,125,42,31,11,11,1,13,33,3,0,3,0,0,0,0,0
22200964,True,LAL,14400,113,32,18,14,6,0,11,26,3,2,5,1,2,3,2,3
22200964,False,GSW,14400,105,53,40,13,14,1,10,30,4,2,6,0,1,0,0,1
22200965,True,BKN,14400,102,51,33,18,11,0,12,28,1,3,4,0,5,5,4,5
22200965,False,CHA,14400,86,54,29,25,6,0,14,31,3,2,5,0,1,1,1,1
22200966,True,ORL,14400,119,39,19,20,15,1,5,11,0,3,3,0,1,1,1,1
22200966,False,POR,14400,122,42,27,15,17,0,9,21,1,1,2,0,3,3,2,3
22200967,True,HOU,14400,142,38,21,17,20,1,10,22,4,4,8,1,4,5,4,5
22200967,False,SAS,14400,110,41,25,16,21,0,6,14,1,3,4,0,1,1,0,1
22200968,True,OKC,14400,129,38,24,14,16,1,9,19,2,2,4,2,2,4,2,4
22200968,False,UTA,14400,119,49,31,18,11,1,10,23,3,3,6,0,0,0,0,0
22200969,True,BOS,17400,129,47,25,22,16,1,10,24,4,0,4,2,8,10,4,10
22200969,False,NYK,17400,131,57,30,27,14,0,4,10,4,0,4,1,5,5,3,6
22200970,True,LAC,14400,135,31,22,9,17,0,8,16,0,2,2,1,0,1,1,1
22200970,False,MEM,14400,129,41,28,13,22,0,9,22,1,2,3,0,1,1,0,1
22200971,True,CLE,15900,118,62,30,32,18,1,6,15,6,5,11,1,6,6,4,7
22200971,False,BOS,15900,114,53,33,20,11,1,7,14,8,2,10,5,9,12,8,14
22200972,True,IND,14400,143,42,24,18,11,1,8,17,3,1,4,1,0,1,1,1
22200972,False,PHI,14400,147,50,31,19,10,1,3,8,1,2,3,0,6,6,3,6
22200973,True,WAS,14400,111,35,19,16,15,1,12,25,4,3,7,0,6,6,3,6
22200973,False,MIL,14400,117,54,41,13,15,0,6,15,3,3,6,0,1,1,0,1
22200974,True,MIA,14400,130,36,23,13,4,2,16,41,1,1,2,0,3,3,3,3
22200974,False,ATL,14400,128,33,19,14,9,0,9,18,2,1,3,1,1,2,0,2
22200975,True,DEN,14400,118,44,31,13,20,0,7,18,4,0,4,1,2,3,2,3
22200975,False,TOR,14400,113,46,26,20,24,0,7,15,3,4,7,2,6,8,3,8
22200976,True,SAC,14400,123,38,22,16,15,1,8,21,2,1,3,1,1,2,1,2
22200976,False,NOP,14400,108,37,19,18,10,0,4,8,0,1,1,1,3,4,2,4
22200977,True,DET,14400,104,51,29,22,25,0,2,5,7,5,12,0,3,2,0,3
22200977,False,POR,14400,110,43,21,22,12,0,10,25,1,1,2,1,21,19,2,22
22200978,True,ORL,14400,123,38,19,19,16,2,16,34,2,0,2,1,4,5,4,5
22200978,False,MIL,14400,134,46,36,10,12,0,9,21,1,1,2,0,7,7,2,7
22200979,True,NYK,14400,105,34,23,11,7,1,11,24,0,0,0,0,3,3,0,3
22200979,False,CHA,14400,112,34,21,13,4,0,11,27,0,2,2,2,0,2,2,2
22200980,True,MIN,14400,94,42,29,13,12,0,6,15,2,0,2,0,0,0,0,0
22200980,False,PHI,14400,117,39,23,16,9,0,9,20,0,0,0,1,0,1,1,1
22200981,True,HOU,14400,96,28,15,13,9,0,4,8,3,0,3,0,1,1,1,1
22200981,False,BKN,14400,118,40,30,10,16,0,6,13,0,1,1,0,2,2,1,2
22200982,True,OKC,14400,137,54,18,36,14,2,11,27,2,1,3,1,6,7,4,7
22200982,False,GSW,14400,128,57,35,22,18,1,13,38,2,1,3,0,3,3,2,3
22200983,True,DAL,14400,120,41,24,17,13,2,12,28,3,4,7,0,8,7,1,8
22200983,False,UTA,14400,116,38,20,18,17,0,11,24,1,3,4,0,5,5,1,5
22200984,True,LAL,14400,112,47,28,19,4,0,13,29,3,2,5,1,2,3,2,3
22200984,False,MEM,14400,103,46,31,15,7,1,8,17,1,3,4,0,3,3,2,3
22200985,True,WAS,14400,120,44,30,14,13,0,11,23,1,5,6,1,0,1,1,1
22200985,False,ATL,14400,122,45,25,20,14,0,8,18,0,3,3,1,3,4,3,4
22200986,True,BOS,14400,115,49,31,18,16,2,8,21,1,4,5,1,7,7,3,8
22200986,False,POR,14400,93,41,16,25,13,0,6,14,2,3,5,2,10,12,6,12
22200987,True,MIA,14400,100,29,21,8,19,2,9,20,1,1,2,0,4,4,0,4
22200987,False,CLE,14400,104,36,22,14,18,1,2,5,4,3,7,0,3,3,2,3
22200988,True,NOP,14400,113,56,28,28,4,0,8,19,3,1,4,1,6,7,5,7
22200988,False,DAL,14400,106,44,33,11,13,0,9,24,2,1,3,0,8,5,4,8
22200989,True,DEN,14400,96,34,28,6,10,0,7,18,6,2,8,1,1,2,1,2
22200989,False,CHI,14400,117,42,20,22,15,0,9,19,3,1,4,1,1,2,1,2
22200990,True,PHX,14400,132,55,25,30,18,0,16,36,2,3,5,2,3,5,3,5
22200990,False,OKC,14400,101,65,34,31,15,0,3,8,2,1,3,1,4,5,3,5
22200991,True,LAC,14400,108,32,21,11,15,0,2,4,3,2,5,0,4,4,4,4
22200991,False,TOR,14400,100,29,23,6,20,0,6,13,1,3,4,1,0,1,1,1
22200992,True,DET,14400,103,50,33,17,12,0,8,19,0,0,0,2,8,10,8,10
22200992,False,CHA,14400,113,49,38,11,14,0,13,27,5,4,9,1,4,5,5,5
22200993,True,IND,15900,134,63,50,13,18,0,7,15,5,2,7,2,1,3,3,3
22200993,False,HOU,15900,125,61,35,26,9,0,13,27,3,0,3,3,7,10,9,10
22200994,True,ORL,14400,124,41,24,17,21,2,11,27,4,0,4,5,4,9,7,9
22200994,False,UTA,14400,131,60,38,22,14,0,13,30,3,2,5,3,1,4,2,4
22200995,True,MIL,14400,118,38,31,7,21,0,3,8,6,1,7,0,1,1,1,1
22200995,False,BKN,14400,113,47,27,20,14,1,19,49,7,1,8,0,1,1,0,1
22200996,True,MEM,14400,131,43,16,27,17,0,14,30,2,4,6,0,12,12,4,12
22200996,False,GSW,14400,110,55,32,23,13,0,6,17,3,1,4,0,3,3,0,3
22200997,True,SAC,14400,122,44,24,20,23,0,10,24,0,2,2,2,5,7,4,7
22200997,False,NYK,14400,117,42,34,8,8,1,6,16,4,5,9,4,7,11,9,11
22200998,True,PHI,14400,120,44,24,20,11,0,1,3,6,4,10,1,0,1,1,1
22200998,False,POR,14400,119,35,21,14,10,1,13,32,4,3,7,1,7,8,4,8
22200999,True,WAS,14400,107,48,29,19,15,2,9,19,3,3,6,0,4,4,1,4
22200999,False,ATL,14400,114,45,31,14,18,1,10,25,2,1,3,2,1,3,2,3
22201000,True,MIA,14400,119,39,16,23,12,1,8,17,4,2,6,1,4,4,0,5
22201000,False,CLE,14400,115,45,29,16,16,1,5,11,1,0,1,0,2,2,1,2
22201001,True,MIN,15900,123,48,36,12,15,0,5,11,0,1,1,2,1,3,1,3
22201001,False,BKN,15900,124,35,21,14,10,1,16,37,1,3,4,0,12,12,3,12
22201002,True,SAS,14400,128,43,28,15,10,0,11,23,1,2,3,0,4,2,1,4
22201002,False,DEN,14400,120,43,28,15,18,1,8,20,1,3,4,0,3,3,2,3
22201003,True,LAL,14400,122,42,30,12,13,0,12,27,0,4,4,0,4,4,3,4
22201003,False,TOR,14400,112,35,19,16,16,0,7,16,3,1,4,1,0,1,1,1
22201004,True,LAC,14400,106,49,34,15,9,0,10,23,3,1,4,0,2,2,0,2
22201004,False,NYK,14400,95,49,29,20,14,0,8,17,4,3,7,5,5,10,7,10
22201005,True,CHA,14400,111,49,37,12,12,0,13,28,1,2,3,0,3,3,1,3
22201005,False,UTA,14400,119,56,35,21,12,0,16,36,1,1,2,0,2,2,2,2
22201006,True,DET,14400,115,50,27,23,7,2,7,15,0,2,2,3,2,5,3,5
22201006,False,IND,14400,121,49,36,13,10,1,9,20,4,1,5,1,4,5,2,5
22201007,True,ORL,15900,126,48,33,15,16,1,4,9,3,6,9,0,7,6,2,7
22201007,False,MIA,15900,114,32,22,10,14,1,15,33,2,1,3,0,1,1,0,1
22201008,True,ATL,14400,125,48,26,22,14,0,9,19,3,1,4,2,3,4,2,5
22201008,False,BOS,14400,134,56,35,21,12,1,8,22,4,3,7,1,12,12,2,13
22201009,True,HOU,14400,111,47,34,13,16,1,11,28,2,2,4,0,2,2,2,2
22201009,False,CHI,14400,119,39,24,15,19,2,11,25,2,0,2,2,3,5,2,5
22201010,True,MEM,14400,112,51,23,28,14,0,5,12,1,3,4,2,6,8,4,8
22201010,False,DAL,14400,108,41,20,21,5,0,9,22,0,1,1,0,10,10,3,10
22201011,True,NOP,14400,96,48,35,13,16,1,8,17,1,2,3,2,2,4,3,4
22201011,False,OKC,14400,110,50,27,23,17,2,4,8,3,3,6,1,4,5,2,5
22201012,True,GSW,15900,125,55,28,27,17,0,22,57,1,6,7,2,2,4,1,4
22201012,False,MIL,15900,116,48,32,16,20,0,7,16,2,4,6,0,6,6,2,6
22201013,True,PHX,14400,119,42,30,12,20,0,4,10,0,4,4,1,3,4,2,4
22201013,False,SAC,14400,128,45,21,24,15,0,8,22,4,0,4,0,4,4,1,4
22201014,True,DEN,14400,120,44,22,22,9,0,6,13,3,3,6,1,2,3,1,3
22201014,False,BKN,14400,122,48,31,17,12,1,7,16,2,0,2,0,4,4,1,4
22201015,True,CHA,14400,108,35,22,13,8,0,7,16,1,1,2,0,5,5,2,5
22201015,False,CLE,14400,114,47,32,15,14,1,11,25,0,3,3,0,4,4,3,4
22201016,True,PHI,14400,112,37,26,11,18,1,3,7,2,4,6,0,3,3,0,3
22201016,False,WAS,14400,93,29,19,10,7,0,6,14,4,1,5,1,1,2,1,2
22201017,True,NOP,14400,127,46,24,22,19,1,11,29,1,1,2,0,3,3,2,3
22201017,False,POR,14400,110,45,22,23,16,1,11,27,1,4,5,0,1,1,1,1
22201018,True,SAS,14400,90,60,34,26,9,1,7,15,3,1,4,1,7,8,7,8
22201018,False,OKC,14400,102,56,33,23,13,1,6,13,5,2,7,2,4,5,4,6
22201019,True,LAL,14400,108,45,26,19,23,1,8,18,2,0,2,3,3,6,4,6
22201019,False,NYK,14400,112,36,24,12,13,0,6,15,3,5,8,3,6,9,7,9
22201020,True,DET,14400,117,44,26,18,17,0,6,16,3,3,6,0,12,9,1,12
22201020,False,IND,14400,97,61,37,24,13,2,3,7,1,8,9,2,7,9,5,9
22201021,True,ATL,14400,115,42,27,15,11,0,17,36,2,2,4,6,4,10,10,10
22201021,False,MIN,14400,136,57,46,11,13,0,18,42,0,5,5,0,8,8,3,8
22201022,True,MIA,14400,119,33,18,15,19,0,5,13,3,0,3,0,3,1,0,3
22201022,False,UTA,14400,115,46,24,22,12,0,15,39,2,0,2,0,3,3,2,3
22201023,True,DAL,14400,88,60,29,31,13,3,12,28,3,2,5,2,7,8,5,9
22201023,False,MEM,14400,104,57,26,31,10,1,9,19,3,4,7,1,11,10,5,12
22201024,True,HOU,14400,111,49,19,30,13,0,10,23,3,1,4,2,3,4,2,5
22201024,False,BOS,14400,109,46,29,17,15,0,5,12,1,3,4,2,7,4,1,9
22201025,True,GSW,14400,123,57,47,10,9,0,11,30,1,3,4,1,4,5,3,5
22201025,False,PHX,14400,112,42,18,24,12,0,11,22,3,1,4,2,6,8,6,8
22201026,True,SAC,14400,124,37,20,17,6,2,15,39,1,2,3,1,5,6,5,6
22201026,False,MIL,14400,133,45,29,16,6,1,5,11,2,1,3,1,3,3,3,4
22201027,True,CHA,14400,104,47,30,17,9,0,12,25,2,1,3,0,4,4,4,4
22201027,False,CLE,14400,120,47,33,14,19,0,12,28,3,2,5,0,8,8,4,8
22201028,True,WAS,14400,117,59,40,19,13,0,15,33,3,1,4,2,5,7,2,7
22201028,False,DET,14400,97,40,23,17,16,0,6,13,2,2,4,2,7,9,5,9
22201029,True,TOR,14400,125,39,26,13,19,0,6,13,2,1,3,2,7,9,6,9
22201029,False,DEN,14400,110,37,24,13,14,0,5,12,3,4,7,1,3,4,2,4
22201030,True,NOP,14400,108,54,28,26,19,0,14,32,2,3,5,2,13,10,1,15
22201030,False,LAL,14400,123,39,24,15,8,0,5,13,1,3,4,6,4,10,8,10
22201031,True,OKC,14400,121,30,11,19,12,3,5,10,3,2,5,1,2,3,3,3
22201031,False,BKN,14400,107,42,26,16,15,0,6,12,4,2,6,0,3,3,0,3
22201032,True,SAS,14400,132,35,31,4,10,0,9,20,1,5,6,1,3,4,2,4
22201032,False,ORL,14400,114,37,20,17,16,0,13,29,3,1,4,1,2,3,2,3
22201033,True,PHX,14400,104,47,23,24,9,0,19,43,3,5,8,0,10,10,4,10
22201033,False,MIL,14400,116,52,43,9,9,0,6,14,3,1,4,0,2,2,0,2
22201034,True,POR,14400,107,32,14,18,11,0,10,27,0,2,2,1,10,11,4,11
22201034,False,NYK,14400,123,55,32,23,13,0,9,19,1,0,1,0,4,4,2,4
22201035,True,CLE,14400,109,31,16,15,14,1,6,13,2,1,3,1,2,3,2,3
22201035,False,PHI,14400,118,31,18,13,10,0,5,12,3,3,6,2,4,6,3,6
22201036,True,MIA,14400,138,38,18,20,12,0,9,19,1,3,4,2,1,1,1,3
22201036,False,MEM,14400,119,35,18,17,17,0,4,9,0,4,4,2,1,3,2,3
22201037,True,CHI,14400,114,37,18,19,19,0,6,13,2,4,6,1,7,7,2,8
22201037,False,SAC,14400,117,42,25,17,16,2,8,21,4,0,4,1,9,9,3,10
22201038,True,HOU,14400,114,53,23,30,10,0,4,10,6,6,12,2,4,6,4,6
22201038,False,LAL,14400,110,37,24,13,25,1,5,11,5,0,5,1,8,9,7,9
22201039,True,MIN,14400,102,38,18,20,17,1,7,19,1,4,5,1,1,2,1,2
22201039,False,BOS,14400,104,34,22,12,11,2,10,25,7,1,8,1,2,3,1,3
22201040,True,SAS,15900,128,35,25,10,11,3,18,39,2,2,4,1,9,8,2,10
22201040,False,DAL,15900,137,61,45,16,8,1,9,22,1,1,2,0,9,7,2,9
22201041,True,LAC,14400,134,23,14,9,18,0,9,21,1,2,3,3,2,5,5,5
22201041,False,GSW,14400,126,40,31,9,11,1,18,48,2,2,4,0,2,2,1,2
22201042,True,DET,14400,100,39,27,12,9,0,7,16,0,1,1,6,4,10,8,10
22201042,False,DEN,14400,119,48,36,12,17,1,8,18,5,3,8,1,7,7,5,8
22201043,True,BKN,14400,96,44,24,20,11,1,5,11,3,5,8,0,4,4,2,4
22201043,False,SAC,14400,101,41,20,21,11,0,4,10,0,0,0,5,7,12,6,12
22201044,True,TOR,14400,128,67,44,23,22,0,13,30,7,7,14,6,15,21,11,21
22201044,False,OKC,14400,111,59,38,21,18,1,5,10,7,5,12,0,14,10,4,14
22201045,True,MIL,14400,123,41,25,16,7,0,3,7,1,1,2,0,2,2,2,2
22201045,False,IND,14400,139,40,23,17,6,1,10,24,1,1,2,1,0,1,1,1
22201046,True,PHX,14400,116,50,34,16,11,2,15,33,2,3,5,0,3,3,1,3
22201046,False,ORL,14400,113,53,30,23,14,0,7,15,1,4,5,0,2,2,1,2
22201047,True,CHA,14400,82,47,31,16,12,0,9,19,0,3,3,1,2,3,2,3
22201047,False,PHI,14400,121,48,27,21,7,0,7,14,6,4,10,2,9,11,10,11
22201048,True,ATL,14400,127,47,25,22,8,0,6,14,2,1,3,1,8,8,3,9
22201048,False,GSW,14400,119,54,30,24,8,0,8,23,2,3,5,1,11,10,4,12
22201049,True,CLE,14400,117,47,28,19,19,1,9,18,2,2,4,0,4,4,2,4
22201049,False,WAS,14400,94,45,35,10,13,1,8,19,0,1,1,0,1,1,0,1
22201050,True,CHI,17400,139,59,35,24,19,1,20,42,1,3,4,0,13,7,2,13
22201050,False,MIN,17400,131,65,48,17,11,0,9,23,6,1,7,1,12,5,3,13
22201051,True,HOU,14400,114,33,23,10,16,0,6,15,1,5,6,2,3,5,3,5
22201051,False,NOP,14400,112,49,32,17,19,1,2,6,1,3,4,1,5,6,2,6
22201052,True,SAS,15900,120,50,33,17,20,1,8,16,2,5,7,1,3,4,2,4
22201052,False,MEM,15900,126,64,34,30,20,0,13,29,3,3,6,3,1,4,3,4
22201053,True,POR,14400,112,35,12,23,19,0,12,31,2,1,3,1,2,3,1,3
22201053,False,BOS,14400,126,35,20,15,12,2,3,7,2,3,5,0,6,6,3,6
22201054,True,LAL,14400,110,39,16,23,18,0,14,28,1,2,3,3,2,5,1,5
22201054,False,DAL,14400,111,51,38,13,13,0,13,31,5,3,8,0,4,4,1,4
22201055,True,NYK,14400,116,41,27,14,10,0,4,9,3,4,7,3,2,5,5,5
22201055,False,DEN,14400,110,47,31,16,9,0,12,30,0,4,4,2,8,10,7,10
22201056,True,LAC,14400,108,40,24,16,14,1,4,9,2,1,3,1,1,2,1,2
22201056,False,ORL,14400,113,38,31,7,9,0,7,15,2,2,4,1,2,3,2,3
22201057,True,IND,14400,121,42,25,17,9,1,6,12,2,1,3,0,3,3,0,3
22201057,False,PHI,14400,141,40,25,15,12,0,8,18,2,3,5,0,3,3,0,3
22201058,True,TOR,14400,122,43,33,10,16,1,12,25,2,2,4,0,3,3,2,3
22201058,False,MIN,14400,107,55,37,18,15,2,7,14,3,3,6,1,2,3,2,3
22201059,True,WAS,14400,118,48,26,22,16,0,9,19,3,1,4,0,3,2,0,3
22201059,False,SAC,14400,132,51,31,20,18,0,11,28,3,2,5,2,7,9,6,9
22201060,True,CHI,14400,113,48,27,21,16,1,5,11,3,4,7,1,5,6,5,6
22201060,False,MIA,14400,99,55,27,28,9,0,5,13,5,2,7,3,11,9,6,14
22201061,True,MEM,14400,133,49,31,18,17,0,10,23,1,1,2,0,5,4,0,5
22201061,False,GSW,14400,119,55,36,19,6,0,11,27,6,2,8,2,3,5,5,5
22201062,True,UTA,14400,118,40,19,21,17,0,7,15,2,0,2,1,8,9,2,9
22201062,False,BOS,14400,117,59,30,29,10,0,2,5,3,0,3,0,5,5,2,5
22201063,True,BKN,14400,102,39,25,14,14,1,10,22,4,2,6,2,4,6,3,6
22201063,False,DEN,14400,108,36,20,16,14,1,8,17,2,1,3,0,4,4,2,4
22201064,True,OKC,14400,124,61,38,23,19,2,11,27,2,3,5,1,3,4,1,4
22201064,False,PHX,14400,120,50,30,20,14,0,15,35,4,4,8,2,1,3,2,3
22201065,True,SAS,14400,126,41,33,8,15,0,21,49,1,3,4,0,3,3,1,3
22201065,False,ATL,14400,118,51,38,13,8,2,11,22,3,1,4,3,3,6,5,6
22201066,True,DET,14400,100,53,29,24,7,0,6,12,4,1,5,2,7,5,0,9
22201066,False,MIA,14400,112,45,26,19,12,2,6,15,4,1,5,3,25,16,6,28
22201067,True,HOU,14400,107,43,27,16,8,0,10,23,2,2,4,0,2,2,1,2
22201067,False,NOP,14400,117,46,26,20,15,2,8,16,2,1,3,1,6,7,6,7
22201068,True,MIL,14400,118,55,40,15,9,0,4,9,5,1,6,0,4,3,2,4
22201068,False,TOR,14400,111,37,19,18,19,0,9,20,2,4,6,1,3,4,2,4
22201069,True,POR,14400,102,44,31,13,16,1,11,24,4,1,5,1,2,3,1,3
22201069,False,LAC,14400,117,33,22,11,19,0,7,16,2,1,3,2,0,2,2,2
22201070,True,LAL,14400,111,56,39,17,6,1,6,13,5,4,9,0,2,2,1,2
22201070,False,ORL,14400,105,40,21,19,22,0,9,20,0,2,2,3,4,7,5,7
22201071,True,CHA,14400,115,52,33,19,16,0,11,24,2,4,6,1,2,3,3,3
22201071,False,IND,14400,109,51,35,16,15,0,7,15,2,2,4,3,5,8,5,8
22201072,True,PHI,17400,105,57,33,24,15,0,5,12,8,4,12,7,14,18,12,21
22201072,False,CHI,17400,109,55,27,28,34,1,8,17,3,4,7,0,10,9,3,10
22201073,True,NYK,14400,134,52,40,12,11,0,8,17,3,2,5,1,5,5,5,6
22201073,False,MIN,14400,140,46,28,18,15,1,11,30,2,4,6,0,5,5,3,5
22201074,True,HOU,14400,108,30,11,19,24,0,9,23,3,4,7,1,2,3,1,3
22201074,False,GSW,14400,121,44,26,18,14,0,8,19,1,2,3,4,4,8,4,8
22201075,True,MEM,14400,112,52,29,23,14,0,15,35,0,4,4,5,6,5,2,11
22201075,False,DAL,14400,108,53,37,16,9,0,9,19,0,4,4,1,15,13,4,16
22201076,True,UTA,14400,128,58,32,26,11,1,8,21,3,4,7,2,12,13,4,14
22201076,False,SAC,14400,120,43,22,21,14,2,7,17,2,4,6,3,12,15,7,15
22201077,True,ORL,14400,122,44,25,19,16,2,8,16,2,2,4,4,5,8,4,9
22201077,False,WAS,14400,112,40,28,12,15,1,10,22,4,3,7,1,4,5,2,5
22201078,True,ATL,14400,129,46,22,24,8,1,11,26,2,0,2,2,3,5,4,5
22201078,False,DET,14400,107,45,24,21,11,0,7,18,2,1,3,0,5,4,2,5
22201079,True,BKN,14400,109,47,32,15,14,0,8,17,2,0,2,5,3,8,4,8
22201079,False,CLE,14400,115,45,28,17,15,0,13,31,0,1,1,0,4,4,1,4
22201080,True,NOP,14400,119,36,22,14,21,0,14,28,4,1,5,1,3,4,3,4
22201080,False,SAS,14400,84,34,23,11,16,1,8,20,3,5,8,1,3,4,2,4
22201081,True,SAC,14400,109,49,26,23,10,0,7,17,3,0,3,0,2,2,2,2
22201081,False,BOS,14400,132,45,19,26,15,1,7,16,0,4,4,3,5,8,7,8
22201082,True,LAC,14400,100,51,33,18,18,0,5,10,5,3,8,4,1,5,5,5
22201082,False,OKC,14400,101,49,33,16,14,3,11,23,3,1,4,0,7,7,2,7
22201083,True,WAS,14400,104,44,27,17,16,0,10,22,3,0,3,0,3,3,1,3
22201083,False,DEN,14400,118,49,33,16,15,0,8,20,4,3,7,1,3,4,4,4
22201084,True,MIA,14400,127,28,12,16,10,3,16,35,1,0,1,0,7,7,1,7
22201084,False,NYK,14400,120,41,27,14,15,0,4,10,2,2,4,0,0,0,0,0
22201085,True,TOR,14400,114,45,33,12,19,1,5,11,2,5,7,2,9,11,3,11
22201085,False,IND,14400,118,41,24,17,11,2,4,9,3,5,8,1,18,18,5,19
22201086,True,DAL,14400,125,39,20,19,19,0,6,14,5,5,10,1,5,4,4,6
22201086,False,GSW,14400,127,46,23,23,18,0,13,28,6,3,9,2,8,10,6,10
22201087,True,CHI,14400,91,44,26,18,11,1,5,10,2,1,3,0,4,4,0,4
22201087,False,PHI,14400,116,37,26,11,14,1,5,10,3,4,7,3,5,7,3,8
22201088,True,MEM,14400,130,40,26,14,13,1,9,22,1,5,6,2,2,4,3,4
22201088,False,HOU,14400,125,34,17,17,13,0,10,22,3,2,5,3,0,3,2,3
22201089,True,MIL,14400,130,46,31,15,14,1,11,26,2,3,5,0,11,11,6,11
22201089,False,SAS,14400,94,35,19,16,17,0,6,15,2,3,5,2,5,7,4,7
22201090,True,MIN,14400,125,36,24,12,16,0,13,30,4,3,7,0,7,4,2,7
22201090,False,ATL,14400,124,42,34,8,10,0,17,40,3,3,6,1,15,7,2,16
22201091,True,UTA,14400,115,42,25,17,14,0,14,35,1,1,2,0,3,3,2,3
22201091,False,POR,14400,127,41,21,20,13,1,10,23,2,0,2,0,11,11,2,11
22201092,True,LAL,14400,122,49,28,21,10,1,8,17,3,0,3,1,4,5,3,5
22201092,False,PHX,14400,111,42,27,15,10,0,18,38,1,2,3,2,3,5,4,5
22201093,True,ORL,14400,111,41,21,20,13,0,11,22,1,2,3,0,3,2,1,3
22201093,False,NYK,14400,106,56,36,20,13,0,5,11,4,3,7,2,2,4,2,4
22201094,True,BKN,14400,114,48,25,23,8,0,10,22,3,2,5,0,2,2,1,2
22201094,False,CLE,14400,116,44,26,18,7,1,12,30,1,2,3,2,1,3,3,3
22201095,True,NOP,14400,115,35,17,18,15,2,14,31,3,0,3,2,5,6,3,7
22201095,False,CHA,14400,96,38,26,12,13,0,10,22,0,1,1,2,6,8,5,8
22201096,True,LAC,14400,127,40,26,14,12,1,10,22,2,1,3,0,2,1,1,2
22201096,False,OKC,14400,105,57,33,24,10,2,7,15,2,3,5,0,1,1,0,1
22201097,True,BOS,14400,120,52,36,16,12,0,13,32,5,5,10,3,9,12,3,12
22201097,False,IND,14400,95,48,25,23,15,1,7,15,4,3,7,0,3,3,2,3
22201098,True,WAS,14400,136,53,37,16,12,0,15,33,0,3,3,1,4,5,2,5
22201098,False,SAS,14400,124,40,25,15,12,0,9,18,6,3,9,1,6,6,3,7
22201099,True,TOR,14400,118,34,21,13,20,0,4,10,2,4,6,2,3,4,2,5
22201099,False,DET,14400,97,53,32,21,11,1,3,6,3,5,8,1,8,9,3,9
22201100,True,MEM,14400,151,47,36,11,15,0,15,38,5,2,7,0,4,4,3,4
22201100,False,HOU,14400,114,40,22,18,13,0,10,21,2,1,3,3,3,6,6,6
22201101,True,DAL,14400,109,42,31,11,5,0,8,16,0,2,2,0,11,11,2,11
22201101,False,CHA,14400,117,46,22,24,11,0,8,17,3,3,6,0,5,5,3,5
22201102,True,UTA,14400,116,52,28,24,18,1,10,23,4,2,6,0,2,2,2,2
22201102,False,MIL,14400,144,47,29,18,13,0,4,11,3,2,5,0,4,4,1,4
22201103,True,GSW,14400,120,43,29,14,13,1,18,44,0,0,0,3,6,9,6,9
22201103,False,PHI,14400,112,35,14,21,14,0,6,13,3,3,6,0,4,4,1,4
22201104,True,POR,14400,96,32,19,13,17,1,4,9,1,1,2,0,3,3,0,3
22201104,False,CHI,14400,124,45,27,18,20,1,5,13,0,2,2,0,1,1,0,1
22201105,True,SAC,14400,135,49,33,16,12,2,8,20,1,3,4,1,4,5,5,5
22201105,False,PHX,14400,127,49,30,19,7,0,6,12,2,3,5,1,3,4,1,4
22201106,True,LAL,14400,116,43,28,15,15,0,11,26,4,3,7,2,2,4,3,4
22201106,False,OKC,14400,111,51,29,22,13,1,7,16,2,4,6,0,12,10,2,12
22201107,True,ATL,14400,143,56,34,22,10,1,12,27,3,4,7,3,3,6,6,6
22201107,False,IND,14400,130,56,37,19,15,0,16,38,1,3,4,1,2,3,1,3
22201108,True,MIA,14400,100,39,23,16,15,0,11,26,3,2,5,1,0,1,1,1
22201108,False,BKN,14400,129,47,30,17,15,1,7,19,2,0,2,3,4,7,5,7
22201109,True,DEN,14400,129,41,26,15,9,0,21,50,1,2,3,1,2,3,3,3
22201109,False,MIL,14400,106,49,27,22,13,0,3,9,0,5,5,0,3,3,0,3
22201110,True,PHX,14400,125,37,25,12,13,0,14,30,3,1,4,0,9,9,1,9
22201110,False,PHI,14400,105,42,27,15,11,0,8,18,2,2,4,1,4,5,3,5
22201111,True,SAC,14400,121,48,30,18,19,1,4,8,2,4,6,2,7,9,6,9
22201111,False,UTA,14400,113,48,35,13,13,0,8,18,5,1,6,1,6,7,5,7
22201112,True,LAC,14400,110,47,34,13,15,0,7,16,3,2,5,1,2,2,2,3
22201112,False,NOP,14400,131,34,21,13,30,1,9,19,2,0,2,0,3,3,2,3
22201113,True,CHA,14400,110,49,23,26,14,0,2,4,4,2,6,1,9,7,3,10
22201113,False,DAL,14400,104,53,39,14,18,1,8,21,2,1,3,0,12,8,1,12
22201114,True,LAL,14400,108,50,33,17,11,0,8,19,1,1,2,2,4,6,3,6
22201114,False,CHI,14400,118,31,13,18,14,4,11,24,3,3,6,1,11,12,4,12
22201115,True,ATL,14400,119,43,27,16,12,2,5,10,3,0,3,0,3,2,1,3
22201115,False,MEM,14400,123,56,36,20,14,0,13,27,2,4,6,0,3,2,1,3
22201116,True,BOS,14400,137,59,37,22,10,1,12,30,0,0,0,0,13,13,2,13
22201116,False,SAS,14400,93,38,15,23,13,0,14,30,1,2,3,0,10,9,2,10
22201117,True,CLE,14400,108,43,31,12,15,1,10,24,3,2,5,0,2,2,1,2
22201117,False,HOU,14400,91,32,17,15,9,0,8,19,4,1,5,1,2,3,2,3
22201118,True,ORL,14400,119,62,31,31,7,0,10,21,4,1,5,0,8,8,2,8
22201118,False,BKN,14400,106,56,40,16,13,0,13,27,5,2,7,2,7,7,3,9
22201119,True,TOR,14400,114,38,25,13,20,1,9,21,0,1,1,3,1,4,3,4
22201119,False,WAS,14400,104,52,33,19,14,0,4,9,1,1,2,0,2,2,0,2
22201120,True,POR,14400,112,46,28,18,10,1,11,27,3,3,6,2,2,4,2,4
22201120,False,OKC,14400,118,57,35,22,19,3,5,11,3,3,6,1,6,7,3,7
22201121,True,GSW,14400,96,42,28,14,19,2,15,37,1,1,2,0,5,5,1,5
22201121,False,MIN,14400,99,33,19,14,17,0,9,27,5,4,9,0,4,4,1,4
22201122,True,DET,14400,117,55,22,33,17,0,10,22,6,4,10,5,12,16,9,17
22201122,False,MIL,14400,126,48,32,16,16,0,9,19,7,0,7,3,15,18,10,18
22201123,True,IND,14400,104,43,25,18,15,0,10,20,5,2,7,1,3,4,3,4
22201123,False,DAL,14400,127,69,48,21,11,1,13,33,6,5,11,1,5,5,1,6
22201124,True,NYK,14400,137,54,37,17,16,0,7,16,4,4,8,1,2,3,3,3
22201124,False,HOU,14400,115,50,25,25,15,0,10,20,6,3,9,1,2,3,2,3
22201125,True,UTA,14400,103,46,27,19,6,0,11,24,1,0,1,0,2,2,1,2
22201125,False,PHX,14400,117,30,11,19,13,0,10,21,2,1,3,0,2,2,1,2
22201126,True,DEN,14400,116,41,29,12,9,0,10,23,3,5,8,1,1,2,1,2
22201126,False,PHI,14400,111,41,24,17,9,0,11,27,4,6,10,3,7,9,4,10
22201127,True,POR,14400,90,31,24,7,17,0,4,9,1,1,2,0,1,1,1,1
22201127,False,NOP,14400,124,48,33,15,22,0,8,21,1,2,3,1,5,6,4,6
22201128,True,SAC,14400,115,46,33,13,7,0,17,38,4,4,8,1,14,15,5,15
22201128,False,MIN,14400,119,35,28,7,12,1,8,16,1,1,2,1,10,8,4,11
22201129,True,LAC,14400,124,34,24,10,13,0,4,9,2,3,5,0,3,3,2,3
22201129,False,CHI,14400,112,33,18,15,20,1,6,12,2,1,3,1,3,4,3,4
22201130,True,WAS,14400,130,50,27,23,12,2,6,13,1,1,2,1,6,7,5,7
22201130,False,BOS,14400,111,54,30,24,9,1,9,21,1,0,1,2,5,7,4,7
22201131,True,ATL,14400,120,42,31,11,5,2,11,25,2,1,3,0,4,4,4,4
22201131,False,CLE,14400,118,45,31,14,13,0,12,27,4,1,5,0,6,6,5,6
22201132,True,TOR,14400,106,55,35,20,14,0,4,9,2,3,5,1,0,1,1,1
22201132,False,MIA,14400,92,53,27,26,12,1,12,29,5,3,8,0,6,6,2,6
22201133,True,MEM,14400,113,55,25,30,14,0,2,4,1,2,3,1,2,3,1,3
22201133,False,ORL,14400,108,54,30,24,12,1,8,17,1,1,2,0,2,2,1,2
22201134,True,OKC,14400,134,47,27,20,15,2,9,22,0,2,2,1,6,4,2,7
22201134,False,CHA,14400,137,45,33,12,7,0,10,20,4,5,9,2,4,5,4,6
22201135,True,GSW,14400,120,54,40,14,11,0,16,41,2,5,7,1,3,2,1,4
22201135,False,NOP,14400,109,38,14,24,13,3,6,12,2,3,5,2,4,6,2,6
22201136,True,IND,14400,136,45,29,16,16,1,19,44,2,2,4,1,2,3,1,3
22201136,False,MIL,14400,149,65,47,18,8,0,10,21,3,5,8,1,2,3,3,3
22201137,True,BKN,14400,123,63,45,18,11,0,6,12,1,2,3,1,3,3,2,4
22201137,False,HOU,14400,114,34,24,10,10,0,2,4,3,1,4,4,0,4,3,4
22201138,True,NYK,14400,101,39,20,19,11,0,5,11,2,2,4,1,2,3,3,3
22201138,False,MIA,14400,92,25,11,14,13,1,11,24,1,0,1,0,3,3,3,3
22201139,True,PHI,14400,116,45,19,26,13,0,5,15,3,3,6,1,5,6,5,6
22201139,False,DAL,14400,108,41,24,17,7,0,14,35,3,3,6,0,4,4,1,4
22201140,True,CHI,14400,110,45,29,16,22,1,5,10,2,3,5,1,8,8,3,9
22201140,False,LAL,14400,121,35,20,15,11,2,9,20,3,0,3,3,4,7,4,7
22201141,True,MEM,14400,132,34,16,18,14,0,7,15,4,1,5,0,7,6,2,7
22201141,False,LAC,14400,141,40,26,14,14,0,14,32,1,3,4,0,11,10,6,11
22201142,True,OKC,14400,107,51,31,20,14,3,12,27,3,2,5,0,10,9,2,10
22201142,False,DET,14400,106,48,31,17,10,0,7,18,3,4,7,3,3,4,1,6
22201143,True,SAS,14400,117,50,35,15,8,1,2,4,0,2,2,0,8,8,4,8
22201143,False,UTA,14400,128,53,32,21,11,2,16,36,0,0,0,2,3,5,3,5
22201144,True,PHX,14400,107,46,28,18,16,0,16,35,2,4,6,1,3,4,1,4
22201144,False,MIN,14400,100,47,38,9,5,0,13,30,4,3,7,1,2,3,2,3
22201145,True,POR,14400,80,50,24,26,11,0,6,15,3,2,5,1,4,5,3,5
22201145,False,SAC,14400,120,73,45,28,17,0,7,19,5,1,6,2,7,7,3,9
22201146,True,MIL,14400,99,51,26,25,7,1,4,10,2,2,4,4,3,6,4,7
22201146,False,BOS,14400,140,58,32,26,15,0,10,28,4,3,7,1,5,6,1,6
22201147,True,DEN,14400,88,52,29,23,8,1,10,22,3,1,4,0,3,3,2,3
22201147,False,NOP,14400,107,53,31,22,14,0,9,20,1,2,3,0,5,5,3,5
22201148,True,CHA,14400,91,52,36,16,7,0,7,14,3,1,4,0,3,3,1,3
22201148,False,CHI,14400,121,44,23,21,17,1,8,18,2,0,2,1,6,7,3,7
22201149,True,IND,14400,121,55,38,17,15,1,10,21,8,3,11,0,8,5,3,8
22201149,False,OKC,14400,117,65,41,24,18,0,0,0,0,1,1,1,10,8,4,11
22201150,True,PHI,14400,117,40,30,10,10,0,5,11,5,4,9,0,10,10,3,10
22201150,False,TOR,14400,110,38,21,17,14,0,7,17,4,0,4,0,2,2,1,2
22201151,True,WAS,14400,109,23,20,3,7,0,5,13,4,2,6,2,2,3,2,4
22201151,False,ORL,14400,116,42,26,16,9,2,8,16,1,3,4,1,4,3,2,5
22201152,True,BOS,14400,122,40,28,12,10,1,4,11,2,3,5,0,8,7,4,8
22201152,False,UTA,14400,114,40,25,15,12,1,9,22,4,3,7,1,5,3,2,6
22201153,True,BKN,14400,124,41,19,22,15,0,10,24,2,0,2,0,3,3,2,3
22201153,False,ATL,14400,107,39,19,20,8,0,7,14,5,3,8,0,2,2,1,2
22201154,True,CLE,14400,116,58,35,23,13,0,13,32,4,2,6,0,10,10,3,10
22201154,False,NYK,14400,130,46,26,20,13,0,14,34,3,5,8,2,3,5,3,5
22201155,True,HOU,14400,121,51,30,21,16,1,12,29,4,4,8,0,1,1,1,1
22201155,False,DET,14400,115,47,27,20,9,3,8,20,2,2,4,1,6,5,2,7
22201156,True,MEM,14400,108,55,35,20,11,0,6,13,2,2,4,4,5,8,6,9
22201156,False,LAC,14400,94,41,25,16,11,1,1,2,4,3,7,2,2,4,3,4
22201157,True,MIN,14400,111,39,30,9,13,1,9,22,0,2,2,2,2,4,3,4
22201157,False,LAL,14400,123,38,24,14,13,1,9,20,3,3,6,1,3,4,1,4
22201158,True,GSW,14400,130,43,27,16,23,0,11,31,6,3,9,2,2,4,2,4
22201158,False,SAS,14400,115,31,17,14,19,1,9,21,0,1,1,1,5,6,4,6
22201159,True,POR,14400,114,50,30,20,21,0,12,31,1,2,3,2,5,7,3,7
22201159,False,SAC,14400,138,63,36,27,17,1,8,18,3,1,4,1,1,2,2,2
22201160,True,PHX,14400,100,43,29,14,14,0,4,9,0,1,1,1,6,7,2,7
22201160,False,DEN,14400,93,52,38,14,16,0,3,7,2,1,3,2,6,8,3,8
22201161,True,MIA,14400,129,37,19,18,14,3,10,22,2,0,2,1,2,3,2,3
22201161,False,DAL,14400,122,52,31,21,10,0,19,41,1,1,2,0,5,3,2,5
22201162,True,NOP,14400,122,56,41,15,8,1,13,27,2,4,6,2,4,6,3,6
22201162,False,LAC,14400,114,51,39,12,11,0,5,10,2,0,2,0,3,3,1,3
22201163,True,CHA,14400,108,61,37,24,20,1,15,34,3,5,8,1,9,7,4,10
22201163,False,TOR,14400,128,49,29,20,23,0,9,21,3,6,9,3,6,9,4,9
22201164,True,BKN,14400,111,46,26,20,10,0,13,28,1,3,4,2,13,13,6,15
22201164,False,UTA,14400,110,41,25,16,13,0,8,18,1,2,3,1,2,3,2,3
22201165,True,CHI,14400,128,47,26,21,16,2,10,22,3,1,4,0,6,6,1,6
22201165,False,MEM,14400,107,54,29,25,1,0,8,17,2,3,5,2,7,9,4,9
22201166,True,MIN,14400,105,47,32,15,8,0,3,7,1,3,4,0,3,3,2,3
22201166,False,POR,14400,107,29,21,8,21,0,13,30,1,4,5,1,3,4,2,4
22201167,True,ATL,15900,132,41,22,19,16,0,14,31,2,2,4,1,8,6,4,9
22201167,False,DAL,15900,130,46,28,18,10,0,8,18,3,1,4,0,9,9,1,9
22201168,True,NYK,14400,118,42,25,17,14,2,4,9,5,5,10,1,9,8,6,10
22201168,False,WAS,14400,109,43,24,19,13,1,8,18,2,3,5,1,9,7,2,10
22201169,True,ORL,14400,128,43,23,20,16,1,8,18,3,3,6,0,3,3,2,3
22201169,False,DET,14400,102,41,22,19,9,1,6,13,1,2,3,0,3,3,3,3
22201170,True,SAC,15900,134,64,42,22,14,0,10,23,3,1,4,1,2,3,2,3
22201170,False,SAS,15900,142,63,32,31,16,0,13,29,3,3,6,0,6,6,3,6
22201171,True,HOU,14400,109,42,26,16,11,0,11,26,6,2,8,2,1,3,1,3
22201171,False,LAL,14400,134,58,37,21,12,0,11,27,0,3,3,3,7,9,4,10
22201172,True,OKC,14400,118,38,24,14,23,3,5,10,2,4,6,1,2,3,3,3
22201172,False,PHX,14400,128,46,35,11,14,1,9,20,2,1,3,0,5,5,4,5
22201173,True,CLE,14400,115,51,39,12,15,1,7,17,4,4,8,2,10,10,5,12
22201173,False,IND,14400,105,51,37,14,11,0,7,15,4,3,7,2,4,5,1,6
22201174,True,MIL,14400,117,56,36,20,18,0,6,15,1,4,5,0,1,1,1,1
22201174,False,PHI,14400,104,46,27,19,8,1,9,22,3,4,7,0,3,3,3,3
22201175,True,DEN,14400,112,49,27,22,16,0,10,22,0,3,3,2,6,8,5,8
22201175,False,GSW,14400,110,43,28,15,13,0,1,2,2,2,4,4,1,5,3,5
22201176,True,CHA,14400,100,44,23,21,10,1,6,14,4,2,6,0,7,7,3,7
22201176,False,TOR,14400,120,49,27,22,14,0,7,16,2,1,3,1,2,3,2,3
22201177,True,DET,14400,105,35,19,16,10,0,5,11,2,0,2,0,2,2,1,2
22201177,False,MIA,14400,118,38,24,14,16,1,6,14,0,3,3,1,8,9,3,9
22201178,True,ORL,14400,113,38,24,14,10,0,11,22,3,1,4,1,2,3,1,3
22201178,False,CLE,14400,117,54,39,15,13,3,7,16,1,1,2,1,2,3,2,3
22201179,True,WAS,14400,128,50,27,23,10,0,18,43,2,2,4,0,19,11,7,19
22201179,False,MIL,14400,140,50,39,11,9,0,5,11,2,4,6,5,7,10,5,12
22201180,True,BKN,14400,102,45,34,11,7,0,13,28,2,1,3,1,4,5,3,5
22201180,False,MIN,14400,107,37,24,13,9,0,9,21,1,2,3,3,5,8,5,8
22201181,True,PHI,14400,103,47,26,21,7,1,4,12,2,3,5,0,5,5,1,5
22201181,False,BOS,14400,101,52,34,18,5,0,8,18,5,0,5,1,3,3,1,4
22201182,True,CHI,14400,105,48,25,23,13,1,3,6,0,3,3,2,2,4,3,4
22201182,False,ATL,14400,123,40,31,9,8,1,4,9,3,3,6,0,2,2,1,2
22201183,True,HOU,14400,124,39,22,17,13,0,6,14,4,4,8,4,5,9,5,9
22201183,False,DEN,14400,103,42,28,14,12,1,7,17,4,2,6,1,1,2,2,2
22201184,True,MEM,14400,119,57,30,27,9,0,10,23,1,0,1,0,5,5,0,5
22201184,False,POR,14400,109,43,17,26,11,0,11,25,4,5,9,0,4,4,2,4
22201185,True,NOP,14400,103,44,32,12,12,0,11,22,2,2,4,2,5,4,2,7
22201185,False,SAC,14400,121,46,34,12,13,1,10,23,3,3,6,4,5,8,5,9
22201186,True,UTA,15900,133,42,30,12,14,1,11,25,4,2,6,1,11,10,2,12
22201186,False,LAL,15900,135,38,25,13,16,3,10,21,3,1,4,1,9,10,5,10
22201187,True,GSW,14400,136,56,40,16,17,1,12,32,3,1,4,0,5,5,3,5
22201187,False,OKC,14400,125,46,25,21,20,1,9,21,4,2,6,0,2,2,2,2
22201188,True,PHX,14400,115,49,32,17,10,0,11,23,2,2,4,1,5,6,2,6
22201188,False,SAS,14400,94,43,26,17,13,1,11,25,1,1,2,2,6,8,5,8
22201189,True,DET,14400,108,43,16,27,20,1,8,19,6,1,7,2,8,8,3,10
22201189,False,BKN,14400,123,47,27,20,17,0,6,15,3,3,6,5,6,11,6,11
22201190,True,IND,14400,129,41,20,21,15,1,2,4,4,4,8,1,3,4,2,4
22201190,False,NYK,14400,138,48,29,19,19,0,0,0,2,4,6,2,5,5,4,7
22201191,True,ATL,14400,134,33,22,11,13,0,7,17,3,2,5,0,2,2,1,2
22201191,False,WAS,14400,116,41,25,16,15,0,13,27,3,1,4,1,2,3,3,3
22201192,True,BOS,14400,97,51,32,19,10,0,6,14,3,2,5,1,7,7,4,8
22201192,False,TOR,14400,93,59,37,22,14,0,4,9,3,3,6,2,8,10,7,10
22201193,True,MIL,14400,105,56,38,18,14,1,5,14,2,3,5,0,1,1,0,1
22201193,False,CHI,14400,92,56,22,34,10,0,6,14,0,3,3,2,2,3,1,4
22201194,True,NOP,15900,138,53,37,16,20,0,7,16,3,1,4,0,5,5,1,5
22201194,False,MEM,15900,131,40,32,8,25,0,10,23,1,3,4,1,4,5,3,5
22201195,True,DAL,14400,123,49,36,13,8,0,11,25,2,1,3,0,6,6,2,6
22201195,False,SAC,14400,119,40,20,20,9,0,9,20,4,2,6,0,2,2,0,2
22201196,True,LAC,14400,125,37,22,15,11,0,9,19,0,0,0,1,4,5,2,5
22201196,False,LAL,14400,118,39,24,15,20,0,8,20,1,2,3,1,4,5,4,5
22201197,True,ORL,14400,94,47,22,25,20,0,8,20,3,2,5,0,7,7,3,7
22201197,False,CLE,14400,118,61,31,30,26,2,15,36,5,8,13,2,6,7,3,8
22201198,True,PHI,14400,101,33,17,16,12,1,7,15,1,2,3,1,2,3,1,3
22201198,False,MIA,14400,129,23,11,12,12,6,10,27,2,4,6,0,4,3,2,4
22201199,True,SAS,14400,129,48,37,11,19,0,3,6,4,0,4,1,2,3,2,3
22201199,False,POR,14400,127,48,35,13,14,0,7,15,3,1,4,0,4,4,2,4
22201200,True,UTA,14400,98,37,20,17,17,0,13,27,0,2,2,0,4,4,0,4
22201200,False,OKC,14400,114,33,21,12,16,3,4,10,3,2,5,1,17,17,4,18
22201201,True,PHX,14400,119,50,37,13,9,0,4,10,0,0,0,0,4,4,3,4
22201201,False,DEN,14400,115,49,28,21,7,0,10,22,3,3,6,1,0,1,1,1
22201202,True,CHA,14400,109,40,30,10,16,0,10,27,0,4,4,0,5,5,1,5
22201202,False,HOU,14400,112,36,20,16,19,1,7,16,1,4,5,2,2,4,4,4
22201203,True,IND,14400,115,50,29,21,16,1,8,19,2,3,5,4,6,10,6,10
22201203,False,DET,14400,122,40,25,15,12,2,8,20,3,3,6,1,3,3,1,4
22201204,True,WAS,14400,114,47,25,22,11,0,9,19,3,4,7,4,2,6,4,6
22201204,False,MIA,14400,108,39,26,13,18,0,8,20,2,2,4,3,1,4,3,4
22201205,True,ATL,15900,131,57,45,12,19,2,11,24,1,2,3,0,4,4,4,4
22201205,False,PHI,15900,136,41,24,17,13,2,8,19,3,3,6,2,3,5,4,5
22201206,True,BOS,14400,121,52,39,13,5,0,7,14,8,4,12,0,4,4,3,4
22201206,False,TOR,14400,102,47,19,28,18,0,11,25,1,4,5,2,5,7,7,7
22201207,True,BKN,14400,101,48,28,20,11,0,5,11,3,5,8,0,1,1,0,1
22201207,False,ORL,14400,84,47,22,25,11,0,1,2,4,2,6,0,2,2,1,2
22201208,True,MIL,14400,114,36,25,11,15,1,8,21,7,1,8,1,2,3,2,3
22201208,False,MEM,14400,137,57,26,31,13,1,8,19,4,2,6,0,1,1,1,1
22201209,True,NOP,14400,113,47,26,21,11,0,10,22,1,1,2,1,5,6,1,6
22201209,False,NYK,14400,105,41,26,15,7,0,8,20,1,2,3,1,1,2,1,2
22201210,True,DAL,14400,112,36,27,9,14,1,4,10,4,4,8,0,3,3,2,3
22201210,False,CHI,14400,115,51,18,33,13,0,7,14,3,5,8,1,3,4,1,4
22201211,True,SAC,14400,97,36,18,18,19,2,4,9,5,1,6,0,4,4,0,4
22201211,False,GSW,14400,119,61,32,29,12,0,9,22,2,4,6,2,10,12,4,12
22201212,True,LAL,14400,121,42,28,14,9,0,14,31,3,6,9,0,6,6,2,6
22201212,False,PHX,14400,107,50,30,20,12,0,15,33,0,0,0,0,2,2,0,2
22201213,True,UTA,14400,118,45,24,21,10,2,8,19,2,2,4,1,4,5,5,5
22201213,False,DEN,14400,114,54,33,21,10,1,4,10,0,2,2,0,4,4,2,4
22201214,True,SAS,14400,131,55,31,24,18,1,15,31,2,3,5,0,3,3,0,3
22201214,False,MIN,14400,151,59,39,20,16,1,12,29,4,2,6,1,0,1,1,1
22201215,True,LAC,14400,136,43,24,19,10,0,8,17,1,3,4,1,0,1,0,1
22201215,False,POR,14400,125,42,24,18,17,0,8,20,0,2,2,0,4,4,1,4
22201216,True,BOS,14400,120,35,21,14,12,0,13,37,4,3,7,1,8,8,5,9
22201216,False,ATL,14400,114,46,17,29,20,2,10,23,4,5,9,2,8,10,6,10
22201217,True,BKN,14400,105,51,35,16,12,1,15,35,3,2,5,3,3,6,4,6
22201217,False,PHI,14400,134,46,27,19,16,1,9,22,2,2,4,2,4,6,3,6
22201218,True,CLE,14400,95,43,21,22,9,0,15,38,2,2,4,2,3,5,2,5
22201218,False,CHA,14400,106,48,32,16,15,0,13,28,1,0,1,0,5,5,1,5
22201219,True,MIA,14400,123,33,19,14,17,1,12,29,4,2,6,1,0,1,1,1
22201219,False,ORL,14400,110,28,8,20,25,0,5,13,1,1,2,1,1,2,2,2
22201220,True,NYK,14400,136,40,26,14,14,0,8,20,1,3,4,1,2,1,0,3
22201220,False,IND,14400,141,42,30,12,13,0,7,15,2,3,5,0,11,9,0,11
22201221,True,TOR,14400,121,52,33,19,14,0,10,24,1,3,4,0,2,2,0,2
22201221,False,MIL,14400,105,46,30,16,10,0,12,26,3,0,3,1,3,4,3,4
22201222,True,WAS,14400,109,37,28,9,22,0,5,12,3,4,7,1,4,5,3,5
22201222,False,HOU,14400,114,39,26,13,28,1,3,7,3,0,3,2,1,3,3,3
22201223,True,CHI,14400,103,56,35,21,23,0,9,19,0,4,4,4,5,7,7,9
22201223,False,DET,14400,81,58,41,17,9,0,5,10,0,1,1,1,1,2,1,2
22201224,True,DAL,14400,117,49,29,20,13,0,7,15,1,1,2,0,4,4,2,4
22201224,False,SAS,14400,138,43,21,22,5,0,2,4,3,2,5,0,0,0,0,0
22201225,True,MIN,14400,113,50,43,7,23,0,9,20,5,2,7,1,0,1,0,1
22201225,False,NOP,14400,108,46,28,18,20,0,18,36,2,1,3,2,3,4,4,5
22201226,True,OKC,14400,115,59,33,26,5,1,11,23,1,2,3,0,2,2,2,2
22201226,False,MEM,14400,100,41,22,19,10,1,7,16,2,1,3,0,2,2,2,2
22201227,True,DEN,14400,109,37,21,16,15,0,5,10,1,1,2,1,1,2,2,2
22201227,False,SAC,14400,95,41,24,17,13,2,5,13,0,0,0,1,1,2,2,2
22201228,True,LAL,14400,128,60,43,17,17,0,11,28,1,4,5,0,7,7,2,7
22201228,False,UTA,14400,117,60,37,23,8,0,9,21,2,2,4,0,3,3,2,3
22201229,True,PHX,14400,114,39,32,7,5,0,7,17,2,2,4,0,10,9,3,10
22201229,False,LAC,14400,119,43,30,13,15,0,8,16,4,1,5,0,6,3,0,6
22201230,True,POR,14400,101,37,11,26,16,0,5,10,3,1,4,2,3,5,2,5
22201230,False,GSW,14400,157,59,37,22,14,0,8,21,2,4,6,4,4,7,5,8
42200101,True,MIL,14400,117,51,37,14,6,1,7,16,6,1,7,2,1,2,1,3
42200101,False,MIA,14400,130,45,21,24,11,2,11,27,3,1,4,1,15,14,4,16
42200102,True,MIL,14400,138,40,26,14,13,0,7,17,0,1,1,0,1,1,0,1
42200102,False,MIA,14400,122,45,23,22,19,0,19,46,3,4,7,0,4,4,1,4
42200103,True,MIA,14400,121,27,21,6,27,2,17,44,4,5,9,0,12,10,5,12
42200103,False,MIL,14400,99,39,19,20,10,1,10,24,3,4,7,0,6,6,1,6
42200104,True,MIA,14400,119,37,22,15,14,1,14,34,3,4,7,0,18,16,5,18
42200104,False,MIL,14400,114,42,32,10,16,0,3,7,6,1,7,0,4,4,1,4
42200105,True,MIL,15900,126,64,40,24,10,0,9,22,8,2,10,2,17,19,8,19
42200105,False,MIA,15900,128,45,29,16,23,3,18,41,2,5,7,0,14,12,4,14
42200111,True,BOS,14400,112,39,27,12,14,0,10,27,3,2,5,0,13,12,3,13
42200111,False,ATL,14400,99,34,19,15,18,0,6,13,1,0,1,1,0,1,1,1
42200112,True,BOS,14400,119,60,29,31,12,0,7,16,1,3,4,0,1,1,1,1
42200112,False,ATL,14400,106,40,20,20,10,0,11,27,3,1,4,1,2,3,3,3
42200113,True,ATL,14400,130,41,13,28,8,0,15,32,2,3,5,3,3,6,4,6
42200113,False,BOS,14400,122,44,22,22,16,2,11,29,1,4,5,2,7,6,3,9
42200114,True,ATL,14400,121,55,32,23,13,0,8,18,2,3,5,3,2,5,3,5
42200114,False,BOS,14400,129,48,30,18,7,1,9,21,3,2,5,1,15,13,3,16
42200115,True,BOS,14400,117,42,22,20,7,0,8,16,5,2,7,0,7,7,0,7
42200115,False,ATL,14400,119,40,22,18,11,0,15,34,4,0,4,2,0,2,1,2
42200116,True,ATL,14400,120,51,22,29,17,2,10,24,6,2,8,6,3,8,5,9
42200116,False,BOS,14400,128,56,34,22,27,1,10,26,2,1,3,1,20,18,8,21
42200121,True,PHI,14400,121,30,17,13,17,2,2,5,1,1,2,2,5,7,5,7
42200121,False,BKN,14400,101,38,20,18,16,1,13,29,2,1,3,2,3,5,3,5
42200122,True,PHI,14400,96,47,24,23,15,0,4,10,1,0,1,4,9,13,10,13
42200122,False,BKN,14400,84,43,19,24,18,1,7,15,2,5,7,2,7,7,5,9
42200123,True,BKN,14400,97,43,29,14,16,1,7,19,1,2,3,0,3,3,0,3
42200123,False,PHI,14400,102,49,31,18,12,0,4,11,7,3,10,1,5,6,4,6
42200124,True,BKN,14400,88,50,42,8,12,0,4,8,2,3,5,0,5,5,0,5
42200124,False,PHI,14400,96,38,17,21,10,0,8,20,1,3,4,1,7,8,4,8
42200131,True,CLE,14400,97,53,38,15,14,1,9,21,3,5,8,1,10,7,7,11
42200131,False,NYK,14400,101,38,24,14,13,0,5,11,2,2,4,2,3,5,3,5
42200132,True,CLE,14400,107,49,33,16,16,2,3,7,1,4,5,1,8,9,6,9
42200132,False,NYK,14400,90,41,26,15,12,1,7,17,4,4,8,0,1,1,0,1
42200133,True,NYK,14400,99,49,30,19,11,0,3,6,3,4,7,5,9,11,7,14
42200133,False,CLE,14400,79,43,29,14,13,1,8,18,6,2,8,1,11,9,1,12
42200134,True,NYK,14400,102,31,25,6,12,1,8,17,4,0,4,1,3,4,2,4
42200134,False,CLE,14400,93,47,33,14,10,0,12,28,3,1,4,0,11,4,3,11
42200135,True,CLE,14400,95,53,34,19,15,1,10,21,1,1,2,1,12,12,4,13
42200135,False,NYK,14400,106,37,18,19,16,0,5,14,1,5,6,2,1,3,3,3
42200141,True,DEN,14400,109,39,19,20,10,0,10,24,1,1,2,1,5,6,2,6
42200141,False,MIN,14400,80,31,23,8,12,0,6,15,1,1,2,0,10,9,2,10
42200142,True,DEN,14400,122,28,14,14,11,2,12,28,1,1,2,0,7,5,0,7
42200142,False,MIN,14400,113,41,32,9,13,0,11,28,0,1,1,2,4,5,2,6
42200143,True,MIN,14400,111,37,24,13,16,1,3,7,0,2,2,2,1,3,2,3
42200143,False,DEN,14400,120,35,22,13,16,1,14,33,0,4,4,0,3,3,1,3
42200144,True,MIN,15900,114,35,25,10,16,3,8,19,1,3,4,1,7,8,1,8
42200144,False,DEN,15900,108,35,19,16,14,0,11,27,3,3,6,0,5,5,2,5
42200145,True,DEN,14400,112,36,21,15,12,0,6,16,6,3,9,0,3,1,0,3
42200145,False,MIN,14400,109,39,21,18,22,0,8,19,3,2,5,0,13,4,1,13
42200151,True,MEM,14400,112,51,28,23,15,0,8,18,6,3,9,2,10,10,4,12
42200151,False,LAL,14400,128,43,28,15,12,1,11,25,1,3,4,2,2,4,2,4
42200152,True,MEM,14400,103,59,37,22,15,0,10,23,3,1,4,0,8,8,4,8
42200152,False,LAL,14400,93,54,36,18,19,0,3,6,4,4,8,2,6,6,4,8
42200153,True,LAL,14400,111,51,30,21,13,1,10,22,0,3,3,1,4,5,1,5
42200153,False,MEM,14400,101,56,39,17,17,0,9,22,2,2,4,3,3,6,2,6
42200154,True,LAL,15900,117,65,42,23,13,2,11,24,3,3,6,2,3,5,4,5
42200154,False,MEM,15900,111,59,35,24,19,0,13,30,0,0,0,0,5,5,0,5
42200155,True,MEM,14400,116,52,28,24,10,2,14,35,4,1,5,0,8,8,2,8
42200155,False,LAL,14400,99,55,36,19,16,0,6,13,1,5,6,3,6,9,9,9
42200156,True,LAL,14400,125,47,30,17,8,0,10,21,1,3,4,1,1,1,0,2
42200156,False,MEM,14400,85,41,17,24,14,0,3,7,1,1,2,0,2,2,0,2
42200161,True,SAC,14400,126,44,16,28,14,0,11,26,1,0,1,1,2,2,2,3
42200161,False,GSW,14400,123,65,42,23,9,1,15,38,0,2,2,0,5,5,1,5
42200162,True,SAC,14400,114,43,20,23,21,1,13,29,5,4,9,3,4,7,3,7
42200162,False,GSW,14400,106,48,30,18,17,3,7,18,4,4,8,1,13,12,4,14
42200163,True,GSW,14400,114,63,29,34,15,0,12,30,3,4,7,1,14,15,8,15
42200163,False,SAC,14400,97,66,29,37,21,0,8,19,3,2,5,1,8,9,3,9
42200164,True,GSW,14400,126,61,37,24,11,1,10,25,3,1,4,0,10,10,4,10
42200164,False,SAC,14400,125,43,25,18,8,0,14,33,2,2,4,0,5,5,2,5
42200165,True,SAC,14400,116,42,28,14,18,2,10,24,2,3,5,1,6,5,4,7
42200165,False,GSW,14400,123,43,30,13,11,2,14,34,2,8,10,1,13,9,4,14
42200166,True,GSW,14400,99,70,36,34,22,0,13,35,2,8,10,0,7,7,2,7
42200166,False,SAC,14400,118,54,36,18,20,3,7,15,2,1,3,5,6,11,7,11
42200167,True,SAC,14400,100,48,27,21,12,1,10,25,3,0,3,0,10,9,1,10
42200167,False,GSW,14400,120,53,25,28,10,0,13,32,1,0,1,2,8,10,4,10
42200171,True,PHX,14400,110,61,45,16,18,1,8,19,3,2,5,1,7,8,4,8
42200171,False,LAC,14400,115,40,25,15,10,1,7,15,2,2,4,0,7,7,3,7
42200172,True,PHX,14400,123,34,26,8,20,0,15,32,3,1,4,0,5,4,1,5
42200172,False,LAC,14400,109,45,34,11,17,0,6,15,1,3,4,0,4,3,2,4
42200173,True,LAC,14400,124,42,30,12,15,0,9,23,0,2,2,1,0,1,1,1
42200173,False,PHX,14400,129,33,19,14,11,0,7,15,1,5,6,1,1,2,1,2
42200174,True,LAC,14400,100,41,28,13,15,0,8,20,1,5,6,2,2,4,2,4
42200174,False,PHX,14400,112,43,26,17,13,0,5,11,3,2,5,3,5,8,5,8
42200175,True,PHX,14400,136,50,29,21,6,0,10,22,2,2,4,2,5,6,5,7
42200175,False,LAC,14400,130,38,29,9,9,0,9,20,4,4,8,3,4,5,3,7
42200201,True,NYK,14400,101,52,29,23,9,0,12,27,2,1,3,2,6,4,1,8
42200201,False,MIA,14400,108,54,35,19,12,0,7,18,5,3,8,0,21,16,3,21
42200202,True,NYK,14400,111,38,15,23,13,0,8,20,0,4,4,0,3,3,3,3
42200202,False,MIA,14400,105,30,18,12,13,2,9,23,5,2,7,1,10,7,3,11
42200203,True,MIA,14400,105,49,28,21,18,2,9,18,6,4,10,4,12,14,6,16
42200203,False,NYK,14400,86,47,29,18,18,0,7,16,3,2,5,5,6,9,6,11
42200204,True,MIA,14400,109,35,21,14,22,3,8,17,2,1,3,0,14,12,5,14
42200204,False,NYK,14400,101,36,19,17,19,1,9,19,2,3,5,6,5,10,7,11
42200205,True,NYK,14400,112,52,25,27,9,0,7,16,2,4,6,4,4,6,4,8
42200205,False,MIA,14400,103,36,20,16,15,0,11,25,3,5,8,2,9,9,1,11
42200206,True,MIA,14400,96,42,19,23,16,1,4,8,4,6,10,0,20,14,4,20
42200206,False,NYK,14400,92,65,45,20,8,0,6,13,3,4,7,6,16,14,9,22
42200211,True,BOS,14400,115,55,34,21,10,0,8,19,3,2,5,0,3,3,1,3
42200211,False,PHI,14400,119,40,23,17,21,0,23,53,2,3,5,1,2,3,2,3
42200212,True,BOS,14400,121,51,31,20,16,0,6,15,2,2,4,4,10,12,6,14
42200212,False,PHI,14400,87,55,24,31,8,2,7,14,3,1,4,2,6,7,5,8
42200213,True,PHI,14400,102,48,24,24,14,0,2,6,1,6,7,1,1,2,0,2
42200213,False,BOS,14400,114,46,27,19,15,1,9,20,4,4,8,1,6,7,5,7
42200214,True,PHI,15900,116,41,17,24,14,0,10,24,2,4,6,1,6,6,2,7
42200214,False,BOS,15900,115,61,37,24,16,1,6,14,2,1,3,0,2,1,0,2
42200215,True,BOS,14400,103,39,27,12,18,0,13,33,1,0,1,4,4,7,3,8
42200215,False,PHI,14400,115,45,25,20,17,1,11,27,3,1,4,0,4,4,1,4
42200216,True,PHI,14400,86,37,20,17,14,0,3,7,1,2,3,0,6,6,2,6
42200216,False,BOS,14400,95,39,29,10,11,1,5,12,2,3,5,0,8,8,2,8
42200217,True,BOS,14400,112,39,24,15,11,0,10,25,2,5,7,1,2,3,1,3
42200217,False,PHI,14400,88,45,28,17,6,0,6,13,1,1,2,2,1,1,1,3
42200221,True,DEN,14400,125,39,26,13,16,0,17,38,0,8,8,4,2,6,4,6
42200221,False,PHX,14400,107,67,42,25,6,0,6,12,1,2,3,1,4,5,3,5
42200222,True,DEN,14400,97,46,29,17,10,1,5,11,4,4,8,1,6,7,6,7
42200222,False,PHX,14400,87,39,25,14,13,1,10,20,2,1,3,2,7,8,3,9
42200223,True,PHX,14400,121,59,39,20,13,1,10,21,1,0,1,3,5,8,5,8
42200223,False,DEN,14400,114,50,31,19,16,0,16,36,2,0,2,2,2,4,3,4
42200224,True,PHX,14400,129,52,39,13,16,0,6,14,3,1,4,4,8,11,6,12
42200224,False,DEN,14400,124,38,23,15,15,0,10,22,3,2,5,2,4,5,3,6
42200225,True,DEN,14400,118,57,40,17,8,0,6,13,5,4,9,0,4,4,2,4
42200225,False,PHX,14400,102,53,34,19,14,0,5,12,3,4,7,2,11,7,4,13
42200226,True,PHX,14400,100,46,37,9,24,0,4,9,1,2,3,0,7,7,1,7
42200226,False,DEN,14400,125,41,26,15,17,0,8,18,2,2,4,3,6,8,5,9
42200231,True,GSW,14400,112,54,39,15,13,0,19,51,4,2,6,4,12,11,5,16
42200231,False,LAL,14400,117,62,32,30,10,1,9,18,4,1,5,1,4,5,4,5
42200232,True,GSW,14400,127,48,30,18,11,1,12,32,2,2,4,1,13,14,6,14
42200232,False,LAL,14400,100,42,22,20,18,0,9,20,2,3,5,1,3,4,3,4
42200233,True,LAL,14400,127,34,18,16,21,0,8,21,1,4,5,1,5,4,2,6
42200233,False,GSW,14400,97,43,26,17,9,1,10,24,2,2,4,0,10,8,1,10
42200234,True,LAL,14400,104,35,14,21,4,0,9,18,1,3,4,0,6,6,3,6
42200234,False,GSW,14400,101,42,29,13,17,1,8,18,0,4,4,2,4,5,1,6
42200235,True,GSW,14400,121,52,37,15,9,1,8,19,2,5,7,1,2,2,1,3
42200235,False,LAL,14400,106,40,23,17,9,0,12,26,1,1,2,0,5,4,2,5
42200236,True,LAL,14400,122,56,27,29,12,0,3,6,0,1,1,0,9,9,6,9
42200236,False,GSW,14400,101,43,25,18,8,0,7,17,4,1,5,1,6,7,3,7
42200301,True,BOS,14400,116,45,31,14,13,0,7,17,7,2,9,0,3,3,1,3
42200301,False,MIA,14400,123,40,25,15,12,0,15,38,3,2,5,2,6,7,5,8
42200302,True,BOS,14400,105,66,47,19,6,0,2,4,1,3,4,0,1,1,0,1
42200302,False,MIA,14400,111,47,23,24,9,1,13,34,0,4,4,3,17,10,3,20
42200303,True,MIA,14400,128,36,21,15,15,1,8,20,2,1,3,0,14,13,1,14
42200303,False,BOS,14400,102,39,21,18,14,0,1,2,2,0,2,5,5,10,6,10
42200304,True,MIA,14400,99,41,14,27,11,1,10,23,0,1,1,0,4,4,0,4
42200304,False,BOS,14400,116,45,25,20,9,0,4,10,5,1,6,0,8,8,4,8
42200305,True,BOS,14400,110,51,34,17,20,0,5,11,7,5,12,3,9,11,5,12
42200305,False,MIA,14400,97,37,20,17,18,0,7,17,6,2,8,6,6,11,7,12
42200306,True,MIA,14400,103,43,24,19,17,2,7,17,3,2,5,2,9,8,2,11
42200306,False,BOS,14400,104,51,33,18,10,1,5,12,0,3,3,5,6,10,7,11
42200307,True,BOS,14400,84,55,40,15,11,0,2,4,1,1,2,1,5,6,6,6
42200307,False,MIA,14400,103,44,21,23,13,0,14,33,1,3,4,1,12,11,5,13
42200311,True,DEN,14400,132,34,24,10,11,0,12,30,3,3,6,4,4,7,5,8
42200311,False,LAL,14400,126,46,30,16,18,1,9,19,2,3,5,0,5,5,2,5
42200312,True,DEN,14400,108,36,20,16,16,1,12,31,2,2,4,2,1,2,1,3
42200312,False,LAL,14400,103,41,20,21,17,1,7,14,1,8,9,1,7,7,5,8
42200313,True,LAL,14400,108,48,27,21,13,0,7,17,1,1,2,3,7,10,7,10
42200313,False,DEN,14400,119,32,14,18,16,0,8,18,1,1,2,2,10,11,7,12
42200314,True,LAL,14400,111,49,30,19,16,1,14,31,4,0,4,2,3,4,1,5
42200314,False,DEN,14400,113,37,28,9,16,0,9,18,1,1,2,1,2,2,1,3
42200401,True,DEN,14400,104,51,32,19,12,0,11,23,2,1,3,1,6,7,3,7
42200401,False,MIA,14400,93,41,28,13,14,1,8,22,2,3,5,4,13,15,7,17
42200402,True,DEN,14400,108,41,23,18,20,0,4,8,5,3,8,1,3,3,2,4
42200402,False,MIA,14400,111,42,29,13,21,1,6,15,3,3,6,0,6,5,3,6
42200403,True,MIA,14400,94,48,34,14,14,1,10,23,3,1,4,1,9,5,2,10
42200403,False,DEN,14400,109,59,38,21,8,0,10,20,4,4,8,1,6,4,1,7
42200404,True,MIA,14400,95,51,33,18,10,0,4,9,3,1,4,1,5,6,3,6
42200404,False,DEN,14400,108,40,25,15,16,0,7,15,2,4,6,0,5,4,0,5
42200405,True,DEN,14400,94,44,27,17,13,0,4,8,3,2,5,0,3,2,1,3
42200405,False,MIA,14400,89,42,24,18,15,1,9,23,5,2,7,0,10,8,1,10
52200101,True,MIA,14400,105,35,20,15,18,1,14,33,2,4,6,1,25,24,6,26
52200101,False,ATL,14400,116,33,21,12,10,0,5,12,4,3,7,1,2,3,0,3
52200111,True,TOR,14400,105,60,41,19,6,0,7,18,2,3,5,3,1,4,4,4
52200111,False,CHI,14400,109,57,40,17,16,1,7,14,4,6,10,0,4,3,3,4
52200121,True,LAL,15900,108,54,29,25,16,1,8,18,4,1,5,1,0,1,1,1
52200121,False,MIN,15900,102,52,34,18,23,0,8,19,0,4,4,1,7,6,2,8
52200131,True,NOP,14400,118,39,22,17,11,0,8,19,1,1,2,1,2,3,3,3
52200131,False,OKC,14400,123,42,29,13,9,1,11,24,2,0,2,1,3,3,0,4
52200201,True,MIA,14400,102,32,23,9,16,1,5,11,4,0,4,0,7,7,3,7
52200201,False,CHI,14400,91,34,17,17,11,1,3,6,2,1,3,2,4,6,4,6
52200211,True,MIN,14400,120,42,24,18,14,0,4,11,2,2,4,0,3,3,2,3
52200211,False,OKC,14400,95,38,27,11,15,1,6,14,5,2,7,0,7,3,1,7
